targett	ambulance	
purge	corps	
catapult	MMA	
ratchet	tension	
bankroll	radical	
disarm	Tigers	
underwrite	arrangement	
gobble	credit	
impugn	service	
overplay	hand	
withstand	adventure	
stabilise	Karzai	
adjoin	chapel	
humiliate	she	
enfurate	I	
reassign	wife	
redirect	energy	
imbue	output	
sieze	government	
boggle	mind	
amplify	issue	
lighten	exposure	
spel	anyting	
belittle	process	
honro	number	
reconfirm	price	
regade	line	
procure	service	
ck	deal	
co-sign	document	
obliterate	I	
ok'd	request	
unfreeze	how	panel	
laminate	it	
laud	Wolak	
finesse	it	
resurrect	note	
refine	offering	
pawn	brat	
madea	that	
rekindle	hope	
unzip	tent	
militarize	force	
instil	order	
re-secure	asset	
beseech	you	
blogg	Katrina	
mobilise	thousand	
outbid	it	
dishonor	conviction	
outnumber	one	
re-type	letter	
vacate	decision	
portend	what	
transcend	argument	
cock	ear	
sm	I	
adulterate	Bible	
ridiculize	he	
crucify	I	
subsume	gain	
sculpt	giraffe	
guz	what	
',	mormon	
unde$tood	me$$age	
bouild	relationship	
usee	thing	
showcase	band	
customise	port	
suround	pipe	
slaughter	animal	way	
stun	he	
wagin	tail	
infiltrate	area	
redeploy	troops	
topple	government	
sate	desire	
<3	Max	
deliverd	car	
refold	napkin	
answetr	all	
eatt	it	
assuage	concern	
outshine	they	
orderd	meal	
itemize	it	
pre-screen	vendor	
purchace	vehicle	
squirm	way	
sabotage	pizza	
slit	screen	
sidestep	obvious	
expend	effort	
demote	Dick	
outrank	he	
replenish	cash	
slay	goliath	
vanquish	competition	
using	word	
recoment	she	
derail	process	
reinvigorate	process	
consolidate	act	
overstate	it	
bedevil	US	
eschew	procedure	
mismanage	effort	
developiong	browser	
aquire	Firefox	
devastate	refinery	
influnce	cubism	
findin	restaurant	
cary	it	
let'	place	
automate	work	
ameliorate	evil	
flatter	me	
repurposing	joke	
rehash	ground	
retell	story	
got	them	way	
co-found	group	
smash	head	
decode	ability	
hurried	home	
swab	arm	
Excuse	me	
gladden	heart	
legalize	marriage	
promulgate	spread	
mimick	appearance	
clinch	it	
liken	it	
compress	them	
simulate	impact	
dub	Scientology	
outlive	usefulness	
perpetrate	action	
cultivate	interest	
pre-organised	transport	
reposition	itself	
counteract	this	
loosen	muscle	
elongate	posture	
Pack	possession	
cram	possession	
unpack	everything	
reassemble	something	
tread	water	
bogging	you	
evade	seeker	
subtract	year	
profess	oath	
embody	diversity	
prioritizing	spending	
emailed	friend	
organise	tour	
Grow	Cactus	
repel	rodent	
absolve	he	
ingratiate	they	
beckon	I	
hoe	row	
upsizing	application	
restructure	data	
configure	component	
retest	query	
retrace	path	
exert	degree	
implies	knowledge	
decipher	story	
lather	face	
liberalize	system	
evoke	spirit	
unfold	secret	
mend	fortune	
civilize	you	
beguil	time	
codify	law	
coordinating	policy	
misunderstand	he	
haule	coat	
rearrange	gear	
arouse	purpose	
twirl	antenna	
expunge	conversation	
collide	glance	
thrust	contraption	
waggle	finger	
padlock	owl	
mow	lawn	
repaint	bench	
delimit	piece	
overwrite	table	
skim	page	
thresh	leaf	
whine	avoidance	
scrutinize	face	
glorify	business	
retable	three	
splatter	window	
shoo	mason	
flay	he	
zigzag	way	
inhale	oxygen	
sublicense	work	
acquit	he	
advertize	debate	
redistribute	part	
fine-tune	feed	
optimise	performance	
maximise	benefit	
asses	self-regulation	
benefited	world	
augment	skill	
outgrow	ability	
outweigh	concern	
putt	package	
subsidize	rate	
mobilize	labor	
reemploy	everyone	
devolve	power	
oust	Yanukovych	
sterilize	male	
reprocess	slag	
stabilize	it	
observing	they	
adore	Balzac	
burned	theatre	
pinpoint	date	
reshape	plot	
curtail	immigration	
trivialize	culture	
firebomb	headquarters	
discredit	resemblance	
entrust	power	
colonise	coastline	
degrade	%	
narrate	part	
pique	interest	
espouse	brand	
co-write	song	
delineate	number	
inhibit	expression	
gild	copper	
liberate	suspect	
entertain	idea	
expropriate	more	
spout	kind	drivel	
perpetuate	dictatorship	
mollify	Sunnis	
equate	dictatorship	woman	
reestablish	link	population	
libel	George	
dread	it	event	
plunder	resource	
scour	Alabama	wall	
obey	law	
outsource	op	responsibility	
curate	show	
appease	it	appetite	
pave	way	
underestimate	time	
revalue	asset	currency	
compile	report	statistics	
crystallize	issue	
duplicate	process	
substantiate	existence	story	
capitalize	word	
stifle	investment	
harass	he	shipping	
validate	some	
lash	canoe	
solicit	assistance	vote	
coerce	people	
unify	aim	tribe	
re-read	it	
downgrade	status	law	
stimulate	idea	
hinder	you	
deceive	people	mankind	
imperil	tanker	
overwhelm	foe	force	
allot	seat	
unload	film	track	
mash	it	
sketch	plan	
echo	answer	
whack	it	nigger	
swivel	head	
pacify	Vietnam	insurgency	
incubate	they	
chalk	it	
inspect	roof	shard	
aswer	phone	question	
misrepresent	themselves	experience	
charger	more	
detonate	bomb	
poss	weapon	
waive	fee	
slot	he	
cloak	himself	
revolutionize	way	field	
fertilize	egg	
interrogate	him	
shun	treatment	
regenerate	city	
swirl	mixture	
sip	tea	
implant	chip	
trim	nail	flowerbed	
ponder	it	
popularize	definition	
cheat	bit	
enlarge	mosque	
bombard	homepage	he	
commercialize	work	motorcycle	
enslave	Moriori	half	
gauge	anger	rivalry	
puree	it	
dislocate	arm	
Play	Quidditch	
ruffle	skirt	feather	
whir	warning	
tuck	notebook	it	
solace	he	
lure	Don	
suffocate	he	
usher	Dobby	
simplify	task	legislation	
rewrite	query	application	
haunt	he	
baffle	Quinn	
lull	world	
usurp	sovereignty	throne	
quicken	pace	
fetch	beer	
spew	lie	that	
taunt	he	dudley	
lend	one	capital	
fascinate	I	he	
disclaim	intention	liability	
override	matter	that	
enrich	society	
efface	he	
waver	wood	
refill	glass	
heave	dudley	trunk	
whisk	plate	
rev	car	
unravel	it	
growl	muggle	
reapply	filter	
autograph	page	
herald	arrival	end	
scorn	peril	
wean	million	
outlaw	union	
gloss	thing	
sequester	dioxide	
alleviate	burden	some	
reprieve	person	
re-establish	agreement	place	
dispose	it	
revitalise	relation	
purchasing	credits	
ascertain	performance	
dismantle	workshop	
taper	which	
reconstruct	Europe	
paralyze	system	
engender	that	
expedite	review	
impede	approval	marriage	
frustrate	ambition	
transpose	story	
disdain	label	
dramatize	result	story	
stoke	jealousy	
conflate	they	
discard	Shakespeare	
hasten	effort	
nourish	writing	
immerse	themselves	
chronicle	destruction	
unearth	crop	
characterise	style	
bust	cell	goal	
irritate	I	
mutilate	body	
instigate	coup	process	
repeal	Order	
hurl	abuse	planet	
preach	racism	they	
bypass	channel	charge	
brainwash	they	generation	
revoke	Order	it	
partition	system	part	
supervise	Sufaat	labor	program	
weaponize	anthrax	
underscore	point	need	appeal	
centralize	activity	level	
utilise	analysis	treasure	fund	
obligate	ECS	
envision	format	wikiHow	
utilize	development	architecture	Mr.	
picket	project	site	
soften	approach	
accelerate	move	particle	
sue	Casualty	Condoleeza	
batter	San	
heal	self	body	
denote	object	apogee	
overtake	Japan	Earth	
visualize	colour	inside	highway	
recite	detail	stanza	poem	
roam	Rockies	store	
pollute	world	sea	
bleed	we	
flex	muscle	it	
divert	thought	
dung	it	
cripple	destroyer	
cement	perception	
garner	power	digit	
relay	information	datum	
tick	she	criteria	
rewind	film	nanosprings	spool	
lick	gravy	bowel	hummus	
prescribe	they	med	
rub	cheek	it	
subdue	VC	old	
fixed	thumpstar	
reccomend	you	salon	
slap	piece	face	
pardon	French	question	number	
lace	some	I	
complement	desire	they	
summarise	nature	experience	
upload	picture	contact	
bulk	space	
freak	he	
arch	back	
fling	themselves	
eclipse	prominence	
ply	detective	
forge	identity	
personalize	joke	
redesign	Hall	itself	
numb	it	
rescind	pledge	it	all	
recount	definition	legend	
wage	that	
broadcasting	propaganda	
recognise	request	problem	
smack	them	
insure	success	consistent	
transplant	them	plant	
bob	head	
multiply	weight	
impart	flavor	intelligence	
underpin	bias	ruler	
elude	he	Quinn	
devour	romance	that	book	
confine	view	
mumble	apology	
darken	skin	
lengthen	stride	
uphold	principle	democracy	that	
convey	satisfaction	turmoil	information	
posit	future	
hamper	people	innovation	
muddle	you	
rattle	bar	
resize	control	
align	it	
penalise	export	
digest	it	
fuse	soil	
enact	law	regulation	
emphasise	importance	
envisage	convergence	
hone	effectiveness	
preoccupy	policymakers	Karel	
aspire	derivative	
pit	country	
envy	generation	
motivate	citizen	
paraphrase	Clausewitz	
bully	neighbor	
wag	finger	
nurse	child	
acclaim	genius	
bombast	verse	
parody	line	
lament	seduction	
mock	cult	
enlist	work	
prank	way	
bluff	way	
distinguish	civilian	one	gleam	
wield	authority	knife	power	arm	
ramp	insurgency	spin	
affirm	claim	rights	liberty	freedom	
criticise	President	which	what	
deepen	rift	relationship	
beg	they	I	
salute	they	superior	he	each	
encircle	Iran	it	
symbolize	Islam	wealth	
divine	which	thing	
enclose	Star	
arrv.	London	
reconcile	balance	list	
retake	test	control	
deduct	expense	point	this	
leverage	situation	
reschedule	call	
minimize	change	incentive	loss	
violate	law	agreement	right	
frighten	bear	other	me	people	
stab	it	
regain	source	importance	power	status	
reap	reward	
tout	freedom	shower	
infuse	energy	landscape	other	
excite	suspicion	passion	
ink	deal	
zoom	zoom	percent	
disconnect	phone	
scrub	floor	area	kitchen	
dilute	gene	right	
tailor	trip	joke	
clarify	anything	all	
extradite	people	
spoil	princess	dinner	
manifest	itself	they	religion	
rig	it	
recomend	they	
encompass	Brigade	Phoenix	document	
revisit	star	topic	
varnish	painting	
preorder	game	
forgive	margarita	he	
strive	whatever	which	
fulfill	dream	conquer	purpose	request	
summon	Army	
Order	Major-General	
menace	city	
memorize	it	
rotate	tire	
scoop	them	
stain	slice	
reaffirm	relation	commitment	faith	
tweet	support	
analyse	effect	dna	
clutch	railing	glass	mop	
hunting	mouse	
sniff	smell	it	
suppress	this	picture	
levy	toll	
sway	mast	man	
activate	that	right	
incur	consequence	
blaze	overhead	
dangle	foot	
peck	way	
flick	wand	ball	
inherit	mode	earth	miserliness	
pity	he	
complicate	matter	
reiterate	commitment	position	ambition	
maximize	budget	resource	potential	
thwart	intention	
exemplify	danger	
confer	power	
classify	heritage	
punish	Batawi	people	he	agent	
revive	interest	talk	that	economy	drama	
confront	India	Virginia	barrier	
uncover	truth	one	enthusiast	etym	
realise	this	important	
exacerbate	tension	power	exodus	challenge	problem	
foresee	attempt	issue	gridlock	
comprise	island	
reconsider	policy	
reopen	case	investigation	relation	debate	
invoke	god	symbolism	
pin	blame	note	
endanger	Arabia	life	tradition	plan	efficiency	
incite	media	uprising	Macbeth	
harbor	fugitive	
leak	fact	
offend	anyone	you	he	
retrieve	they	dead	them	bowl	
mitigate	cost	impact	
finalize	point	loc	
defy	board	US	law	prediction	rule	
merge	mind	
vault	homeland	
surpass	estimate	what	share	ExxonMobil	
offset	gain	
reimburse	Enron	cost	
void	warrenty	contract	
soak	box	
emit	uva	uvb	sound	
hug	I	son	
spill	Whisky	
kiss	goat	*ss	him	
overcharge	you	I	
wipe	which	dish	forehead	ten	
chant	slogan	
hose	you	
carve	one	square	
confess	involvement	surprise	
norm	it	
rename	bridge	copy	emperor	
fasten	strap	loop	
emphasize	persistence	consumerism	appearance	requirement	
adorn	banknote	triceps	
punch	it	girl	
script	room	
resign	leadership	
committed	suicide	
contemplate	existence	
snatch	snitch	glimpse	it	
whisper	statistic	watch	
enforce	law	rule	impartiality	
rival	that	carnival	
shuffle	foot	
devise	method	way	theatre	
slam	receiver	
embrace	henry	standard	
steady	it	
drum	finger	
steer	he	policy	
dedicate	they	
soar	debt	
heap	disdain	
champion	he	
spark	period	
deter	they	LTTE	mouse	investor	
contradict	report	themselves	I	Richard	land	
endure	criticism	pain	fall	trouble	
authorize	search	opening	
invade	Kuwait	territory	home	mangrove	Moravia	
scan	site	magazine	Internet	collector	
massacre	citizen	
starve	it	
expel	preacher	Russians	you	he	population	
recreate	taking	wheel	dress	group	
summarize	intelligence	revenue	
borrow	it	bike	money	
depict	value	Holocaust	time	existence	contestant	Shakespeare	
cc	you	I	
flesh	detail	story	
probe	coup	machination	
fuck	life	neighbor	you	
tackle	challenge	one	it	snitch	darkness	mountain	
swallow	tablet	it	ash	pride	
veto	move	action	bill	future	
assemble	spacecraft	army	
scrape	sweat	moisture	knee	beard	living	
migrate	distance	
possess	amount	one	knowledge	wealth	soldier	
dump	portion	ingredient	impersonality	
bundle	cheque	
lope	stride	she	
chew	it	food	
administer	iv	initiative	it	
amaze	I	
diagnose	problem	
bump	it	
browse	site	website	catalog	
resist	attempt	urge	
upgrade	it	
embed	few	
cheer	team	he	
designate	Site	
pronounce	Yor-vik	
whip	hair	pace	
closing	loophole	
wai	people	
substitute	it	sequence	
dictate	story	activity	
disguise	sort	
knit	wool	
practise	quidditch	activity	
chill	hand	
exclaim	so	Kurtz	
descend	hill	
safeguard	interest	hundred	
wreck	middle	
buzz	they	
entail	this	kind	cost	control	
harmonize	requirement	
scam	other	
discipline	delinquent	
assassinate	Gen.	Minister	
isolate	Hamas	it	economy	
confuse	making	holder	minute	
broker	that	
embarrass	himself	patron	her	Evelyn	
smuggle	explosive	arm	lab	
curb	activity	desire	spending	enthusiasm	
cite	you	area	negligence	article	
blend	system	vol	
forbid	veil	people	marriage	meat	Iraqis	participation	
trigger	default	cascade	pact	response	referendum	
insert	detail	a	comma	piece	candle	
trademark	everything	
disclose	contents	intention	secret	
intercept	that	
compromise	contract	
coordinate	attachment	supply	
hack	way	system	
bless	you	America	
jam	we	thing	
restore	security	faith	reputation	man	confidence	
populate	Houston	zoo	
reinforce	suggestion	idea	increase	ability	division	role	
sap	confidence	economy	
restrict	you	use	ability	term	
flip	switch	square	
span	period	season	roadway	
mask	it	scent	
squeeze	I	
quit	smoking	
torture	animal	
celebrate	presence	opening	diversity	anniversary	launch	victory	
merit	it	
drown	sorrow	he	this	exchange	
upset	balance	he	
dash	it	
endorse	approach	report	embargo	
sigh	muggle-baiting	
cease	provocation	
pump	money	air	blood	
exploit	which	network	weakness	power	
harbour	extremist	mosquito	
bang	head	
haul	argument	ass	he	horse	
tolerate	it	that	other	people	frost	blasphemy	
sponsor	terrorism	
analyze	proposal	data	thread	datum	that	
accent	sound	
log	email	
await	approval	journey	they	
dig	it	hole	mine	ice-cream	
attain	link	aspiration	solitude	unattainable	objective	
stamp	foot	book	
assert	program	self-respect	
anger	Japan	
disturb	sleep	you	work	functioning	
dislike	society	Americans	which	her	math	
boast	that	area	harbour	
admire	you	crease	Governor(s)	it	he	that	
massage	it	
flee	country	outbreak	town	
dip	pinkie	reserve	finger	quart	
annoy	they	people	
mop	mess	patch	
instruct	I	prosecutor	
boil	piss	
originate	question	nothing	
imprison	her	
stack	box	
recording	audiobooks	
spare	you	he	life	
interrupt	he	
mutter	Quinn	opinion	word	
overthrow	landowner	Charles	he	
burden	one	
aged	5	
caution	member	
characterize	takeover	me	homeopathy	conflict	he	anti-semitism	
compel	they	
beef	preparedness	capacity	
persuade	LTTE	Musharraf	you	user	other	they	us	
render	help	news	
undermine	Pakistan	stability	strategy	argument	confidence	ability	sovereignty	resolve	
manufacture	that	radio	computer	
absent	yourself	himself	
fulfil	obligation	paradigm	promise	demand	duty	commitment	
shout	praise	fire	herself	
detect	lisp	damage	attempt	people	benefit	effect	
explode	yourself	himself	
raid	mosque	headquarters	house	
warrant	weight	conclusion	pickup	
forecast	Nepool	
hook	guy	arm	
alter	point	pattern	life	it	them	rule	law	term	
combat	challenge	unemployment	
suspend	assistance	auhtority	right	persecution	agreement	
outfit	soldier	
wet	area	
charter	ship	which	flight	
foster	kitten	growth	choice	interest	development	
vomit	blood	
tame	they	
extract	one	information	
advertise	pint	video	
remedy	evil	situation	
undergo	trial	change	renovation	pilgrimage	decommission	test	reform	rift	
bare	arm	
encounter	chemical	one	
broadcast	footage	propaganda	
wound	@card@	
hunt	mouse	member	
rinse	soap	
convict	anyone	
integrated	producer	
manipulate	market	anthrax	price	them	they	shutter	thing	region	ambassador	
exclude	individual	he	hand	possibility	
satisfy	requirement	appetite	sommelier	need	appetitie	
dismiss	Chalabi	government	shirt	what	voting	
rear	head	
facilitate	return	attempt	research	improvement	adaption	development	
devote	most	time	
condemn	act	death	massacre	murder	assassination	they	Shakespeare	
overcome	problem	issue	procrastination	disparity	role	
spell	name	word	independence	
alert	we	he	world	
justify	cost	mistreatment	decrease	policy	number	valuation	right	increase	
consume	product	food	trash	fuel	
dwarf	Mr.	
paste	this	text	email	copy	line	
invent	cellfone	pizza	character	kind	word	game	
conquer	Darius	fear	science	territory	Thrace	internet	
poison	Queen	
regulate	emission	everything	this	market	nature	agent	
sex	lineatus	
compose	himself	opera	
pinch	nerve	head	them	pair	
trace	phone	
frame	guy	
integrate	game	economy	
curse	bone	
infect	ant	them	themselves	
enhance	understanding	contrast	ability	readability	knowledge	
tape	screw	
scatter	seed	they	chicken	powder	
anchor	it	currency	
brave	danger	
spin	yarn	
yell	head	
jerk	paper	
swap	vatican	
cloud	pupil	
prohibit	he	
organize	themselves	chairperson	call	maximum	action	event	
rack	hundred	what	interest	
yield	result	fruit	flower	
scare	who	I	predator	miscreant	crap	it	
renew	lease	call	l/c's	visa	embargo	
accomplish	result	work	that	goal	more	this	something	
moderate	price	difficulty	
supplement	activity	debate	measure	
exceed	$	rise	expectation	%	rate	carryover	average	
sacrifice	safety	child	
craft	law	
evacuate	stadium	people	bunch	citizen	facility	population	area	
flash	light	tooth	
stem	outbreak	
undertake	action	path	course	analysis	study	
scratch	you	arm	
chase	thing	other	they	Communists	that	
melt	bras	it	amount	brass	
spray	spray	house	insecticide	
google	it	restaurant	repair	term	recovery	
taxi	you	
string	I	you	
grasp	fact	process	word	connection	rag	it	
grill	dogs	
sum	it	
pride	themselves	it	
trash	it	
witness	fight	mayor	
occupy	life	that	camp	thought	Alaska	field	
alarm	me	court	
sustain	attention	union	breakthrough	unity	siege	
harvest	basil	them	which	crop	
toast	quinoa	israeli	
wrote	it	book	novel	ride	
pile	amount	
survey	note	building	
dissolve	tension	
annex	that	which	
harm	I	they	me	consumer	economy	job	
constitute	group	increase	minority	presidency	personnel	element	work	agreement	contribution	offence	place	transition	
provoke	siege	action	fight	it	laughter	charitable	revolution	
reject	suggestion	attempt	attack	part	they	request	notion	advance	plan	
relax	you	
interpret	Bible	statement	dream	it	factor	
chef	tutorial	
shell	dollar	part	bush	
split	total	word	job	
mold	silicone	
peak	supplies	
brush	island	it	soot	
shift	focus	expectation	representation	
comfort	he	Quinn	
bind	page	
lord	it	
compliment	haug	you	
unite	effort	
seize	control	disc	lamp	arm	harry	it	
resolve	conflict	problem	dispute	crisis	
abuse	position	it	population	
defend	Iran	owner	deal	right	it	dissertation	lie	country	
construct	submarine	avenue	dwelling	theatre	
absorb	child	ray	carbon	waste	much	urine	job-seeker	moisture	presence	water	it	saving	dioxide	
communicate	number	that	detail	information	plan	rhythm	measure	
poll	co-worker	
allocate	piece	point	land	
rent	car	house	Paradero	motel	machine	what	vehicle	room	
greet	member	one	I	servant	he	
evaluate	candidate	he	horse	provider	way	need	property	felicity	relevance	
acknowledge	warming	existence	input	presence	it	
bloody	they	
breed	they	
fool	you	people	predator	
imply	demotion	right	fragility	impact	
screw	missy	everything	
drill	tunnel	
mirror	process	
bend	head	
fold	tent	
transit	tunnel	
assault	employee	
abandon	neighbourhood	process	window	farm	her	house	everything	
signal	priority	beginning	arrival	greeting	
convince	jury	Younis	candidate	Qanooni	parent	lot	they	Hamas	Standards	reader	congress	mother	author	
reward	husband	you	voter	
deserve	leader	support	sympathy	something	quality	star	review	business	respect	punishment	attention	
delay	matter	conflict	
dial	number	Rick	bedlam	
compound	burden	this	value	
shed	hunk	skin	
ban	marriage	chess	backpack	employee	trade	
rip	Stark	ft	u	letter	
skip	one	place	it	step	class	
coin	myself	
crack	other	gum	it	
deposit	it	
dominate	behavior	
phrase	way	
donate	blood	it	$	junk	
solve	problem	concern	mystery	anything	kind	many	
educate	Shia	generation	viewer	people	
assess	background	exposure	effect	inter-animation	distribution	result	value	fact	legality	
divide	Andamans	participant	time	Greece	
perceive	people	he	object	
monitor	donation	finances	media	content	list	matter	way	situation	usage	
permit	discovery	ECS	that	time	
iron	pants	
notify	sender	we	grandmother	you	agent	policeman	
modify	guaranty	Holga	law	content	component	system	it	
investigate	misstatement	possibility	reserve	attack	soldier	way	use	contribution	murder	potential	post	people	
kick	application	Yoko	it	ass	management	ball	
download	it	which	
seal	they	it	container	lid	utterance	hole	
predict	disappearance	thing	Dow	launch	consequence	era	
pop	stuff	
expose	ant	yourself	fragility	
experiment	connection	
surrender	sovereignty	independence	country	mystery	
excuse	I	he	
swing	she	tail	society	
moving	bone	
initiate	conflict	conversation	call	development	stream	scheme	event	
impose	monarchy	form	sanction	worldview	it	term	cost	pain	election	
frequent	RI	that	resturant	society	
knock	boxer	he	rat	she	bowl	thing	wall	elbow	tray	undercarriage	
adapt	itself	strategy	Directive	school	style	measure	Tintin	
wrap	loi	bill	furniture	it	them	
anticipate	analyst	that	it	sample	difficulty	action	
cast	vote	it	wife	
invest	$	vanguard	time	share	billion	
smooth	way	hair	
shine	it	colour	
fry	egg	
detailed	vulnerability	
shelter	Bin	area	
ally	itself	
blame	Bush	situation	everybody	kid	it	he	
eliminate	it	crime	regime	request	requirement	cap	culture	pocket	infestation	call	overlapping	they	
pour	money	oil	it	ml	vodka	ten	martini	
stress	it	humanism	
mount	they	sight	demonstration	slice	production	defence	
bake	bread	wafer	them	
sing	hymn	word	sentence	lesson	chant	anthem	
bike	mile	
plate	them	
burst	tear	they	
compete	firm	
parallel	coast	
accuse	element	Delhi	Dr.	I	government	HANO	us	Shakespeare	Brice	
deny	request	claim	right	equity	this	fact	it	allegation	kind	permission	
owe	much	$	pleasure	pound	francs	debt	
favour	election	route	reform	cohesion	
threaten	fiction	reliability	installation	
arrange	marriage	it	ticket	lodging	excursion	
drag	feet	he	singles	cursor	I	toe	you	rectangle	line	field	curtain	foot	harry	
acquire	answer	strain	volume	fund	source	asset	revenue	technology	type	Firefox	Urchin	talent	company	content	user	
calculate	amount	value	reserve	withholding	share	irr	sum	
adjust	number	value	brightness	exposure	sight	shirt	policy	budget	
expense	it	
cancel	participation	ticket	contract	room	membership	it	lesson	
prompt	fear	call	line	rebellion	
till	it	
sail	Med	Pacific	
cry	wolf	seat	why	
flood	certainty	he	
succeed	he	expectation	
blind	he	
generate	terrorism	confidence	electricity	one	karma	blast	sale	soil	employment	dollar	kilowatt	
assure	Musharraf	you	I	house	he	typical	
urge	he	President	evacuee	resident	parishioner	Arabs	government	commission	her	they	Engels	public	
loose	ak47'	trust	nail	strength	
amend	timeframe	fee	process	constitution	return	question	Directive	legislation	act	
negotiate	plan	space	in	network	intertexts	independence	agreement	constitution	
shadow	Enron	
lock	arm	position	door	he	you	child	
switch	leg	field	component	
suck	it	amount	
ring	testing	bell	it	buzzer	
pause	it	
audit	file	
resume	policy	operation	
vary	intake	flow	style	
default	view	
slip	bottom	
capture	3	figure	Province	inflation	point	personality	option	improvement	Kadesh	Lubumbashi	senate	
strengthen	legitimacy	it	campaign	Karzai	file	muscle	ally	position	cohesion	protection	representation	defens	
grab	chance	something	glass	blender	they	coffee	flower	mary	slice	cab	he	copy	attention	
warn	India	Taliban	they	friend	I	you	he	Europe	
recall	letter	threat	Iraq	name	musician	talk	
afford	protection	cost	treatment	hotel	you	esteem	advisor	that	freedom	
regret	it	decision	this	departure	
strain	myself	
pledge	troops	allegiance	loyalty	they	
crash	check	database	
recover	pic	cost	he	place	shoe	
found	city	publication	family	empire	
freeze	basil	it	
bet	dollar	
opened	eye	door	closet	mouth	reach	
root	Ba'athists	
narrow	pool	it	focus	mismatch	
highlight	skill	text	potential	attention	importance	some	need	item	fact	desire	
rush	it	
rescue	force	people	seeker	you	that	
brain	pinkie	
suit	palette	I	which	you	budget	
sandwich	pepperoni	
bridge	gap	
reform	government	
earn	point	name	coup	status	victory	nickname	reputation	degree	living	percentage	praise	esteem	%	
import	wolf	food	query	data	file	document	
ruin	ability	bond	apartment	hair	deal	shirt	it	
label	that	anonymous	box	efficiency	
plot	chart	stratagem	
distance	character	
pose	danger	threat	risk	concern	challenge	
guide	youth	I	participant	manufacturer	airplane	
submit	offer	change	bid	response	request	timesheet	comment	resume	design	amendment	report	draft	
incorporate	word	comment	change	that	technique	work	this	element	circumstance	region	material	
exercise	gland	control	right	
steal	goods	money	information	design	they	glove	it	horse	wallet	canoe	
favor	conviction	he	expansion	choice	
edit	they	relationship	content	information	file	ConnectionString	
defeat	MMA	purpose	player	Americans	ARVN	Lee	candidate	opponent	enemy	
stretch	kilometer	they	neck	hand	patience	power	
bother	I	bird	child	you	he	
contribute	forecast	$	cache	storyboard	
shoulder	burden	
translate	meaning	it	manuscript	Macbeth	play	
shut	he	door	refinery	plant	system	ear	owl	eye	
climb	Fuji	everything	tree	step	mountain	hill	screech	flight	
reveal	what	variation	anything	process	much	charm	balance	sympathy	
operate	register	boat	
remind	I	you	she	Hamas	yourself	he	john	
commit	crime	action	ourselves	suicide	sin	mistake	image	they	error	
attract	investment	love	you	many	more	majority	million	reader	audience	thousand	whale	yacht	some	eater	firm	best	everyone	public	
assist	Iraq	user	Transwestern	we	Iran	you	I	they	loss	him	opening	manager	leaver	country	
transfer	message	sum	service	quinoa	this	
combine	isda	painting	art	approach	field	collection	idea	filter	solution	it	two	genius	work	
explore	cosmos	it	room	house	country	countryside	limit	artwork	experience	that	impact	tactic	ice	site	consequence	way	more	mind	
teach	lesson	they	ballroom	that	I	in	it	Icelandic	he	one	dance	method	people	
tear	system	it	fin	stuff	one	bottom	book	
double	it	
cap	change	
obtain	anthrax	strain	education	row	part	missile	degree	doctorate	image	card	quaffle	object	paper	power	thing	m.a.	
lift	restriction	cap	hand	it	people	eyebrow	arm	finger	leg	forefinger	head	
match	spreadsheet	offer	value	name	run	eye	position	writer	desire	
reply	epithet	
settle	root	lawsuit	tax	
inspire	people	form	you	movement	kid	love	uneasiness	hope	film	style	painter	debate	
rank	wikiHow	area	city	item	Balzac	
tag	player	
conclude	real	what	time	agenda	
empty	glass	
promote	peace	cause	song	one	stabilization	trading	campaign	interest	measure	product	movement	standard	Page	creation	development	progress	respect	understanding	book	
secure	election	head	refund	oil	blessing	port	it	control	#	unit	document	future	recognition	investment	industry	region	fund	deal	
welcome	appointment	Brian	discussion	he	it	cresson	opportunity	introduction	announcement	
oppose	Karzai	move	use	nomination	he	which	program	access	control	legislation	
admit	9/11	that	glibness	which	
enable	Enron	woman	user	owner	rac	delivery	oil	program	campaign	them	world	you	name	security	they	us	G5	factor	assessment	company	it	consumption	Putin	
score	coup	point	school	run	they	blinder	
collapse	process	field	
smoke	cigarette	pipe	
fee	mycelium	
pressure	it	Musharraf	Taliban	I	government	
gift	slice	
wave	flag	arm	cab	
inform	I	you	staff	Tana	they	we	parliament	consumer	
distribute	this	heat	share	letter	wear	project	page	copy	work	
install	rom	sump	FusionRetail	fence	that	Biometrics	some	wall	camera	NT	component	
battle	adult	infection	unemployment	
shoe	foot	
recognize	Hezbollah	fire	need	name	you	that	person	failure	role	extent	farmer	
skin	nose	
sport	linen	
beat	daughter	head	States	comer	Lopez	Ruy	price	expectation	a&m	this	drum	heat	odd	wing	he	England	
repeat	lie	allegation	rhythm	mantra	it	step	sin	expression	mistake	grave	detective	appreciation	process	
shake	hand	bottle	head	it	idea	ground	cologne	kitchen	
supply	she	it	cent	certificate	
screen	baggage	
advance	grade	theory	cause	interest	
graduate	laude	
slight	Center	
bomb	they	Iraq	barracks	
hate	Qaeda	void	other	dad	wheel	drama	walk	it	whenever	job	place	sushi	dentist	restaurant	privacy	man	modernity	someone	something	savage	they	each	
demonstrate	number	temperament	capability	action	challenge	training	record	self-awareness	interest	urgency	diversity	conformity	level	allegiance	ambition	value	
guarantee	trial	generation	delivery	favour	it	you	degree	source	
collect	strain	premium	amount	signature	water	animation	datum	storey	colony	animal	sample	stack	shot	donation	comic	they	thing	comment	
bite	we	arm	you	it	I	scruff	belly	dust	
revise	they	posting	language	text	
finger	somebody	
brief	those	I	
connect	phone	which	Francisco	ruin	her	Lee	Rivertrail	page	feed	landmark	
race	donkey	
sight	Antarctica	land	
count	headline	it	margin	25	can	present	die	spore	value	cost	
observe	family	change	customs	silence	humanity	rising	
discover	possibility	that	they	affair	storey	Wikipedia	sample	Souffleur	remnant	manuscript	who	black	novel	he	seam	
load	version	track	boat	Gigaloader	they	reference	
nail	it	owl	
block	up	attempt	it	aisle	content	
survive	it	honeymoon	war	climate	curse	termination	translation	
cash	it	
host	several	he	event	call	which	dinner	website	some	Game	video	group	festival	center	
command	cabinet	operation	respect	
storm	church	it	
prefer	that	we	which	somebody	cage	color	service	parts	layout	ham	Caribbean	one	flag	prey	cupcake	
bill	all	
shape	destiny	what	growth	English	development	prospect	
seed	gallery	
mail	she	they	envelope	application	copy	
spread	opinion	word	it	this	arm	democracy	Islam	
wind	film	window	
rock	they	
tour	Chernobyl	place	company	
click	button	level	Group	grid	line	arrow	Log	menu	security	
determine	route	distribution	value	likelihood	equivalence	design	level	election	
weather	storm	hurricane	
slow	fungus	process	change	
identify	cell	man	source	issue	attachment	all	project	we	PEREZ	gap	perception	orientation	Polaroid	that	problem	filter	use	it	skill	force	Shakespeare	piece	themselves	Sea	
destroy	stockpile	industry	everything	message	society	value	agreement	infrastructure	town	Russia	tool	hero	they	what	
execute	doer	atrocity	act	agreement	survey	policy	document	it	law	that	form	duty	changeover	plan	
advise	I	you	Duke	Joe	they	people	
define	what	those	content	that	word	fan	behavior	santorum	place	strategy	responsibility	data	rule	arrangement	
affect	future	ability	system	what	I	population	biology	people	way	ship	pet	office	route	distribution	prosecution	size	data	aspect	result	quality	harmonization	standard	author	wellbeing	
hire	firm	Sara	replacement	people	agent	you	someone	car	they	guy	company	adult	he	opposite	them	girl	me	Don	laborer	
announce	arrival	console	wii	day	ruling	this	end	start	home	location	intention	tool	suspension	plan	
wash	goodness	inside	gravel	food	it	overall	item	bottle	neck	you	they	car	hand	
stick	he	head	penny	it	
smell	it	smoke	sent	concrete	cupcake	garbage	Aegean	what	
suspect	government	
jump	stair	fencing	
magic	you	
cool	climate	
title	MYTHS	Knights	Letter	Impacts	
adopt	guideline	shepherd	lab	dog	layout	strategy	which	minute	technique	rule	provision	currency	alphabet	
damage	surface	them	we	
mix	order	it	concentration	query	letter	comic	
advice	I	
aim	blow	
encourage	element	bombing	warfare	ruler	outfit	everyone	you	recipient	they	anyone	I	citizen	gallery	Easterner	coup-d'etat	integration	investment	participation	woman	child	reform	student	Republicans	rebellion	Abakumov	
implement	Accord	stategy	it	number	provision	policy	System	agenda	feature	regulation	programme	
stage	d'etat	fair	musical	
indicate	guilt	improvement	race	challenge	relationship	role	
declare	freeze	emergency	holding	fire	myself	Congress	war	friendship	session	result	support	2014	he	Balzac	independence	victory	up	game	
sink	ship	they	tooth	
sample	cocktail	rum	
balance	basket	interest	body	it	
doubt	that	source	
gain	control	comfort	skill	trust	pound	entry	prestige	dominance	seat	user	little	access	ground	esteem	immortality	reputation	title	recognition	
fear	reprisal	you	death	distribution	
finance	murderer	infrastructure	school	programme	growth	shortfall	
reserve	right	block	one	update	
equal	volume	amount	percent	advantage	
average	$	
exchange	idea	fire	word	look	data	information	
stock	store	
strike	conferee	deal	US	balance	he	target	I	camp	match	Sahel	particle	
waste	time	money	
initial	page	it	what	
fit	stuff	meeting	bill	need	scenario	you	330i	them	bar	cat-flap	
circle	moon	
hang	he	it	city	Kurtz	head	
relate	case	
maintain	security	base	relation	weight	structure	program	level	output	it	cash	product	store	relationship	many	performance	policy	majority	exception	office	sort	contact	population	quality	provision	control	sovereignty	alliance	
suffer	effect	setback	death	loss	occupation	damage	planning	harm	inflation	
marry	man	mother	Canadian	Althea	María	who	Anne	Ewelina	Balzac	physician	Thomas	widow	Richard	
lay	plan	egg	knowledge	dude	claim	her	chicken	which	agent	flag-stone	table	pen	procedure	traps	groundwork	
cook	food	kidney	eggplant	chicken	breakfast	
smile	smile	
locate	university	sunrise	
protect	they	centre	bus	you	interest	ourselves	we	security	clan	Israel	pilgrams	skin	Harry	option	code	Peter	property	need	sea	public	environment	euro	consumer	themselves	
feature	ARD	baby	host	assembly	ingredient	journalism	reform	Scientologist	store	catalog	content	adventure	governess	Balzac	clothes	character	
track	family	someone	change	settlement	immigrant	poop	bed	people	tire	invoice	phone	iPhone	law-breaker	mouse	drone	David	
grant	bail	interview	out	commission	charter	access	right	license	status	he	
export	data	object	schema	table	view	it	query	
fish	command	
assume	power	responsibility	correlation	value	control	understand	ease	aware	
murder	classmate	he	wife	king	
sale	Leach	truck	
judge	case	book	
associate	hand	you	cancellation	Islam	Muslims	
extend	wish	offer	contract	hand	rights	invitation	courtesy	time	life	it	politeness	welcome	storyworld	application	capacity	position	influence	decision	programme	training	scope	period	district	
seat	people	
respond	way	what	
fail	quiz	it	this	I	test	
express	view	sentiment	interest	sympathy	discontent	concern	solidarity	wish	symmetry	support	idea	it	disagreement	hope	surprise	regret	confidence	opinion	admiration	thanks	dissatisfaction	sadness	hatred	
approve	all	report	list	purchase	type	$	he	application	which	subsidy	commission	amendment	edition	
cross	bridge	street	male	border	Iran	path	channel	room	threshold	mind	each	boundary	lawn	shin	river	Antarctic	sea	
ride	horse	broom	Nimbus	elevator	bicycle	
hide	motivation	bone	data	item	story	
compare	Sara	duty	they	it	hotel	flag	thing	observation	value	innovation	farmer	he	
update	number	file	it	calendar	room	report	site	whatever	listing	ConnectionString	information	
limit	amount	they	you	scope	number	manoeuvring	regulation	update	
demand	recognition	protection	it	talk	freedom	claim	this	much	action	that	encore	
blow	thing	himself	herself	house	mind	it	airplane	aircraft	smoke	
win	election	war	award	cash	fight	which	card	victory	freedom	restaurant	favor	certificate	drive	game	championship	bronze	point	case	struggle	district	colony	independence	medal	
separate	itself	fact	father	they	male	pair	meat	candy	data	property	
deliver	information	it	copy	tenth	all	opinion	good	data	dollar	objective	result	amount	
fan	page	
snake	wire	
chair	Council	
realize	it	what	mistake	improvement	so	potential	expectation	
taste	same	that	rainbow	beverage	
film	summer	film	
hit	States	Mumbai	eye	stage	country	$	Stuart	Iraq	road	5	spurt	corssing	nail	3	ground	it	me	portrayal	character	everything	area	roadway	bludger	bludgers	shot	he	branch	poll	
influence	course	direction	style	result	economy	governor	novelist	writer	culture	poetry	choice	school	
replace	M.S.	staff	review	copy	l/c	they	it	bulb	hose	most	screen	valve	board	tire	model	jurist	Steffen	John	memory	sanitisers	need	atom	governor	milk	extract	commissioner	one	modernism	line	Mojmír	veteran	
intend	what	10mm	
warm	you	it	
spot	cabinet	friend	talent	few	
throw	lot	conviction	stone	peanut	observation	rock	punch	everything	muscle	any	I	he	treat	leg	blood	party	it	percent	bile	towel	they	them	quaffle	dodge	something	apple	powder	kind	shoulder	look	sausage	glance	
miss	physical	something	tidbit	message	cpy	I	which	deal	school	meal	show	nail	food	appointment	day	it	piece	drawer	wedding	time	what	breakfast	waterfall	word	hogwart	friend	he	opportunity	church	
promise	measure	delight	prize	thing	tote	revenge	that	education	harry	power	
trust	you	I	Scott	car	gut	dealer	store	mechanic	he	yourself	they	MSM	whom	Doctor	work	me	him	baby	
imagine	painful	process	capability	they	tension	yourself	moment	justification	hotel	surprise	company	solution	man	he	time	scene	feeling	regret	situation	conversation	commodity	thing	battle	
quote	official	ceo	gas	reserve	James	source	$	job	event	I	writer	stanza	agency	founder	conversation	he	pair	
dry	resource	them	
direct	government	NASA	appeal	remark	
perfect	them	
pull	bombing	force	note	few	those	this	water	it	gut	military	test	tile	color	car	that	operation	tooth	head	sleeve	girl	weed	wad	duster	book	door	he	brush	tick	reality	theatre	
heat	inside	home	oil	
launch	attack	operation	offensive	site	mission	VI	human	lifeboat	they	that	way	supplies	astronaut	campaign	petition	LibriVox	novel	appeal	
sense	incredulity	mind	hypocrisy	weakness	
catch	element	plane	day	you	someone	it	eye	crook	band	fallout	tuberculosis	her	chicken	#1	angle	snitch	headset	yokel	express	glimpse	sight	they	name	
reflect	position	gdp	exposure	comment	call	change	name	tradename	holding	same	ability	yorkedness	agreement	result	bcf	view	diversity	history	nature	concern	outcome	appearance	item	event	attitude	importance	priority	situation	need	conflict	fear	cost	improvement	difficulty	expertise	fashion	failing	
achieve	concentration	goal	regime	equality	reversal	progress	date	health	aim	fame	that	outcome	result	freedom	equivalence	what	good	popularity	peace	objective	right	market	this	boost	status	cohesion	level	efficiency	promotion	independence	promise	respectability	effect	harmonization	resolution	
conference	you	
practice	drill	Pilates	ballet	bit	
press	sandwich	he	button	hand	roof	ctrl	face	
dress	joke	
target	Israel	Senators	leader	Zeitgeist	customer	advertiing	
mark	income	time	end	section	transition	everything	you	development	night	thing	economy	change	trend	
format	file	one	control	
impact	result	yield	
draw	conclusion	denunciation	protest	view	line	lot	character	staircase	people	pole	egypt	inspiration	attention	support	that	game	
suppose	which	clerk	alive	
approach	one	I	option	desk	challenge	art	situation	earth	mission	glow	it	
board	plane	dog	he	flight	
represent	date	liquidation	dozen	generator	company	person	order	firm	environment	model	step	county	stone	extent	idea	wing	repudiation	star	class	fifths	cooperation	that	energy	%	nation	peak	individual	Shakespeare	agent	suburb	need	film	rights	conservative	progressive	love	
schedule	time	this	call	appointment	
figure	solution	it	$	thing	I	some	
estimate	reserve	production	size	speed	rate	number	prevalence	requisite	
forget	question	it	everything	underwear	trainer	drink	training	memory	history	punctuation	word	study	moment	herb	which	thing	birthday	
touch	leg	it	butt	saddle	pinky	cricket	he	something	me	people	luminol	post	woman	money	surface	army	piece	carpet	ceiling	
e-mail	I	assistant	Vince	
model	flow	price	
single	group	participant	he	
feed	hungry	cat	they	baby	flake	what	bread	food	bloodworm	scrap	item	it	live	broccoli	dog	water	pinkie	pinky	one	he	many	stuff	she	amt	ROS	meter	you	
avoid	mutilation	detection	which	alcohol	week	place	Home	confrontation	disaster	temptation	you	variability	it	crowd	weekend	those	awkwardness	clothing	problem	confusion	he	hole	stranglehold	collapse	irritation	word	transfer	compliance	increase	feeling	
style	hair	it	
select	program	application	cluster	EnronOnLine	product	name	copy	paste	suit	route	definition	license	design	race	officer	object	item	promotion	group	line	asterisk	author	document	data	control	that	audience	
finish	what	note	college	road	force	job	sentence	it	dinner	work	year	cpa	development	that	task	some	list	one	debate	school	two	editing	term	
egg	he	
laugh	laugh	what	
voice	opposition	fear	opinion	
raise	line	$	capital	money	havoc	much	that	question	hand	doubt	arm	which	matter	mug	laugh	head	rate	objection	issue	presumption	century	levy	
focus	light	attention	culture	effort	mind	
benefit	we	mind	society	he	producer	
bar	adult	tooth	
interested	me	
improve	defense	education	efficiency	reliability	neighborhood	English	quality	essence	emission	performance	capacity	outcome	article	coverage	Muslim	control	yield	state	chance	proposal	transparency	security	wellbeing	safety	they	text	competitiveness	institution	impact	surveillance	awareness	co-ordination	productivity	access	climate	nutrition	prospect	standing	infrastructure	
propose	marriage	outage	solution	season	rule	structure	intersection	evaluation	zone	system	counter-measures	formula	correction	specification	drink	adoption	creation	that	indicator	
respect	site	fact	other	religion	sentence	tradition	fellow	collar	aspect	principles	
structure	deal	data	
sell	c	call	shade	burger	power	it	asset	share	fish	segment	house	stuff	car	feed	item	bunch	product	kit	phone	property	morcilla	type	strawberry	book	paper	eHow	they	artwork	candle	which	
key	building	
rise	standard	
fire	mortar	editor	company	us	them	shell	round	dozen	ammunition	
involve	India	allegation	child	girl	attack	Murphy	transfer	Syria	sector	train	death	drive	issue	number	challenge	solving	skirt	element	cost	alignment	citizen	Erika	us	churning	externality	lawmaker	level	precursor	
attend	conference	concert	market	party	event	meeting	School	that	school	drill	LFTD	Tots	it	funeral	dentist	Centre	wedding	Wycliffe	opening	exhibit	festival	lecture	Program	stand	circumcision	communion	hearing	university	
search	ambulance	name	he	corner	
drop	period	she	sandbag	you	some	weight	any	we	they	truck	issue	piece	message	amount	them	quaffle	area	he	manner	conversation	letter	one	pipe	point	
join	Guard	league	tour	I	company	wagon	Enron	we	effort	partnership	club	chorus	liberal	Monotheism	team	branch	list	international	Google	audiobook	family	force	alliance	Program	queue	Org	they	sdot	you	group	euro	Facebook	union	rebellion	NATO	
purchase	cropduster	lithograph	both	Appel	it	tool	mmbtu	that	ft	material	ton	Color	what	home	furniture	car	nissan	BMW	vehicle	some	dress	ticket	item	meal	package	quinoa	them	advertisement	lease	
prepare	copy	credit	he	feast	ally	ham	son	test	breakfast	papers	risk	mould	solution	quasi-state	yourself	container	quinoa	food	directive	programme	measure	source	
attempt	suicide	
train	insurgent	puppy	he	she	I	people	waitstaff	hijacker	writer	staff	manager	
reference	manufacturer	deal	merger	id	what	ant	license	schema	it	
wish	holiday	return	birthday	best	all	success	evening	year	
contain	the	memo	anthrax	item	material	information	optionality	list	some	value	lot	mosque	content	citral	employee	park	milk	series	field	control	source	group	reference	application	Access	answer	book	number	data	head	greeting	proposal	text	Elements	provision	plot	portrayal	detail	plastic	deposit	lagoon	monument	majority	
remove	tumor	cap	wrinkle	lethargy	he	it	contact	grip	finger	shelf	nest	thinset	tree	water	%	video	wrap	distraction	saponin	part	material	field	group	notebook	setting	check	reference	carbon	cuticle	bar	subsidy	penalty	
seek	cover	paradise	waiver	assistance	resolution	answer	remedy	help	quality	supplies	construction	work	cehf	nuke	relationship	anecdote	information	asylum	route	decision-making	surroundings	ground	solution	reconciliation	employment	source	talk	term	
kid	I	
lack	experience	information	sponsorship	flavor	efficiency	number	nature	stature	access	address	interface	defens	
fill	rank	number	vacancy	subject	life	later	Park	pipe	those	tire	role	order	bowl	it	you	bottle	heart	one	square	box	holder	mind	seat	stillness	glass	ramp	
credit	claim	statement	
fly	interceptor	jet	mission	plane	London	member	flag	aircraft	car	foot	gnome	
fight	they	Shia	weapon	crime	horror	circle	bear	Dragon	government	country	aids	intruder	terrorism	war	insurgency	pressure	german	election	disease	battle	War	
arm	India	
transport	shipment	blood	oil	I	that	civilian	migrant	chicken	shuttle	Fritzi	it	oxygen	
father	child	son	
describe	insurgents	casualty	Sha'lan	face	code	themselves	activity	story	he	Montalvo	project	picture	her	ant	world	which	judgement	background	it	jet	information	object	form	element	she	structure	type	data	style	drama	action	murder	
pick	name	Michael	gray	it	member	thing	windfall	destination	egg	old	horse	they	man	song	I	jug	car	food	order	dresser	those	nose	which	issue	color	one	them	clothes	object	bag	phone	dill	relationship	glass	lock	someone	people	question	
trade	land	derivative	power	
complete	that	paperwork	tour	i/c	transaction	work	job	task	review	agreement	checklist	test	fit	thing	vision	operation	pattern	education	partnership	tragedy	sequence	play	sense	line	evacuation	
refer	question	off	everyone	they	I	client	you	he	friend	matter	which	
research	animal	some	vet	ant	
display	prop	drink	dedication	value	chart	view	data	summary	document	xml	field	sale	page	box	property	
wonder	need	
piece	encounter	
notice	development	order	it	cretin	difference	change	one	breed	few	people	you	this	entity	
gas	it	
release	statement	more	information	space	they	some	carbon	co2	kinect	Xbox	material	Enron	issue	change	rfp	staff	all	content	work	Eugénie	power	detail	edition	video	album	
plant	grass	egg	basil	seed	cutting	
sort	candidate	problem	windscreen	that	you	arrogant	data	
rest	forehead	
wear	uniform	brass	trousers	Levi`s	collar	boot	mask	underwear	stuff	clothing	suit	insignia	heart	chemise	lingerie	pants	shirt	dress	them	her	lot	T-shirt	wig	slipper	thing	glove	best	sundress	outfit	pant	short	expression	that	tie	katan	they	flannel	sunglasses	suffering	glass	apron	robe	affair	hat	
ensure	degree	management	supply	compliance	life	misunderstanding	confusion	security	industry	destruction	opportunity	unique	prosperity	safety	development	coordination	movement	competition	structure	survival	existence	
treat	it	she	he	they	sick	Essex	people	everyone	you	water	I	customer	we	yourself	way	employee	pet	pain	daughter	patient	her	competition	those	crop	them	custom	country	man	Facebook	both	
picture	he	yourself	
establish	peace	system	correlation	line	cap	link	pack	strength	equivalent	firm	rule	value	contact	principle	number	sort	regulation	conclusion	framework	requirement	level	method	profile	programme	tie	foundation	institution	environment	center	one	he	guideline	constitution	union	climatology	themselves	phase	itself	hope	Albania	factory	outpost	
shop	it	
risk	war	nothing	life	conflagration	it	notice	
cover	year	stuff	tsunami	service	tonnage	p&i	experience	cost	gamut	range	flooring	aspect	it	dish	torso	shoulder	them	wall	requirement	game	product	provision	inch	mile	area	span	proof	grave	state	fraction	much	
accept	accord	that	inevitable	Sikkim	advice	result	this	responsibility	call	supply	language	idea	Jesus	people	I	it	surrender	organization	fact	theory	Christ	donation	bill	thing	money	knowledge	sacrifice	situation	concept	life	number	six	amendment	proposal	all	lie	term	domination	
share	power	country	fact	this	mail	transport	experience	story	information	resource	matter	they	love	taste	cottage	taxi	desire	bathroom	position	high-five	technology	sort	file	setting	pathogen	regret	account	pot	
interview	you	intern	I	contractor	candidate	expert	Mario	President	owner	one	founder	Simon	Professor	Tina	mathematician	him	Christopher	Robert	
ship	material	they	he	
claim	ground	appellation	supremacy	draw	who	citizenship	life	support	
effect	I	
explain	delay	pattern	it	thing	action	more	benefit	this	they	procedure	wrong	plan	what	process	problem	reason	situation	incompetence	repair	all	shift	behavior	cause	
drink	beer	lot	water	it	soda	Coke	Pepsi	you	lager-beer	coffee	aquavit	he	whisky	tea	one	half	
lie	foundation	Rockridge	Avenue	object	
subject	solution	
test	weapon	tool	it	water	claw	work	equipment	part	this	gullibility	image	DNA	
carry	arm	deal	banner	bomb	death	papers	order	it	you	cargo	they	lifeboat	work	child	Winston	bottle	glass	that	future	this	activity	detector	lantern	passenger	weight	meaning	load	he	command	bag	valise	rifle	sponge-bag	baby	message	trunk	suit	broomstick	transportation	good	amendment	verification	baggage	disease	punishment	mean	torch	
interest	advertiser	they	
save	he	life	$	space	friend	victim	file	dollar	money	everybody	some	thousand	I	time	trouble	situation	trip	hassle	more	you	schema	structure	language	data	object	table	report	page	change	Peter	deal	we	harry	earth	world	country	labor	euro	
table	amendment	question	text	
kill	Shaikh	member	engineer	Musharraf	themselves	Abdul	Iraqis	people	parent	neighbor	ten	thousand	guard	he	you	hundred	innocent	plan	cap	student	spirit	sailor	critter	egg	pet	everyone	4	number	talk	leader	her	@card@	astronaut	six	mouse	anyone	somebody	mosquito	harry	million	father	daughter	Andre	pharaoh	
contact	sender	Francisco	I	Gerald	Hope	Cindy	people	Sherri	you	they	Michelle	archive	representative	railway	we	Centre	company	James	zim	Joan	Shirley	Vernon	Offices	member	minister	son	team	family	
further	goal	image	agenda	activity	
design	invitation	curriculum	plan	badge	furniture	page	chart	format	rocket	apartment	
land	job	shuttle	soldier	clerk	machine	
agree	equivalent	
break	heart	activity	rule	barrier	this	chorion	bank	window	country	stereotype	hip	ice	glowstick	egg	application	everybody	stick	stone	asphalt	mold	
spend	time	life	decade	trillion	minute	more	much	day	billion	year	that	all	afternoon	money	$	rest	hour	k	thousand	lot	bit	fortune	buck	most	energy	amount	deal	evening	period	month	
license	operator	
link	company	York	arm	page	css	finger	immigration	assistance	
choose	destiny	that	brake	cruise	parakeet	Pros	other	place	Practice	type	later	headline	one	hotel	food	medicine	structure	hashtag	car	kind	response	domain	them	pad	affair	who	subset	president	setting	what	many	she	alternative	
age	@card@	
accord	rite	
drive	Americans	Spain	model	problem	change	low	car	he	both	it	suv	I	Palestinians	storm	there	evolution	everybody	mum	increase	growth	that	
concern	activity	whom	they	origin	agriculture	limitation	copy	annexe	proposal	inadmissibility	rating	administration	implementation	substance	module	increase	need	array	Lucien	he	material	condition	
require	examination	either	someone	we	information	approval	download	assistance	review	documentation	confidence	technique	group	use	cleaner	bedding	habitat	cleaning	type	delivery	I	jacket	re-boot	lot	member	what	knowledge	worth	material	me	card	hour	training	clothing	approach	attention	name	vote	work	supplement	guidance	everyone	consideration	consultation	regulation	redistribution	set	policymaker	datum	consent	education	commitment	
clear	water	opossum	Halls	throat	table	Duffy	
act	morality	ghillie	another	
fund	travel	Hezbollah	removal	modernization	project	meetups	proportion	deficit	spending	
measure	pain	section	size	weight	volume	attention	ROS-concentration	flux	head	cranium	time	
type	it	link	unitedway.enron.com	
message	market	
vote	they	National	what	time	
copy	message	this	Sarah	letter	piece	it	rule	source	view	data	line	
near	Chatham	end	
decide	that	what	mode	smell	
position	cutting	
appear	Francis	
serve	population	year	Tigers	purpose	need	subpoena	country	way	food	you	salad	customer	fare	they	something	good	breakfast	it	goal	city	all	drink	stewardess	lunch	term	tea	that	community	
build	case	report	pipeline	service	shuttle	check	microcomputer	that	intuition	song	refinery	factory	plaster	steam	ship	one	furnace	army	this	archive	plant	city	most	manual	resource	wikiHow	structure	base	system	mansion	building	society	road	railway	theatre	community	requirement	net	business	institution	station	bridge	wall	market	canal	
expect	civilian	some	9/11	contract	call	Murphy	notice	change	lot	unexpected	what	he	form	steak	experience	miracle	they	sleep	this	mircle	something	food	it	ambience	much	visitor	flash	country	I	someone	child	you	drawing-room	center	nothing	development	bump	
document	status	age	reaction	dream	content	problem	it	
sound	theft	note	death-knell	
matter	what	
address	substance	recruitment	rights	trading	many	commission	some	calculation	that	concern	allegation	this	marriage	nation	note	knowledge	gap	reason	man	word	I	oas	no	people	point	issue	corruption	ramification	inequality	risk	fragility	they	cabinet	
bear	message	cap	brunt	name	stare	many	flower	ship	sword	this	marking	conclusion	goal	alignment	witness	
lose	weapon	favor	Dean	track	business	$	roof	parent	what	job	insurance	water	trust	weight	he	territory	all	muscle	bit	mine	key	pound	drawer	patience	helicopter	chunk	hamster	fortune	lawsuit	strength	point	phrase	touch	seat	yield	population	life	beast	tarantula	I	sensation	Radcliffe	ground	half	son	child	autonomy	everything	place	appeal	apparition-quality	it	access	penchant	ability	use	
top	it	
account	period	
attack	Husseiniyas	they	someone	bear	people	Iran	that	rabbit	pinkie	ARVN	country	foot	me	defector	coverage	website	church	loudspeaker	patent	style	suspect	lung	
discuss	subject	these	what	issue	this	anything	concern	area	detail	trademarking	follow	file	it	participation	proposal	tuning	that	view	response	lawsuit	Wars	matter	initiative	diet	option	transaction	arrangement	questionsand	topic	implication	work	background	seasoning	literature	trend	winter	scandal	resource	objective	policy	Directive	effect	federalization	
regard	solution	date	view	that	artwork	future	relation	negotiation	what	information	tax	examination	requirement	guideline	order	condition	report	
access	EnronOnline	info.	profile	e-mail	internet	event	information	database	money	
rate	answer	egg	pcs	it	light	route	Rohingya	Shakespeare	
fall	victim	that	chair	
charge	separatist	rate	$	more	much	day	he	price	fee	I	charge	we	it	dime	30.00	you	phone	thing	arm	that	they	friend	load	
note	the	dynamic	uneasiness	point	touch	unavailable	umbrella	importance	
cause	trouble	thousand	apprehension	wound	result	tension	issue	difficulty	we	this	lyric	that	he	reduction	sky	problem	disease	snake	fall	damage	everyone	symptom	atrophy	I	dresser	response	crane	site	exodus	bottleneck	percent	person	hypnosis	chicken	harm	slowdown	offense	rot	fire	cost	suffering	discord	ruin	expense	shame	disruption	change	stir	upset	business	
remain	town	Rangatira	something	secretary	member	
enjoy	prospect	freedom	comment	bashing	weekend	e-mail	presentation	holiday	internet	myself	period	ride	strength	weather	it	time	they	kitten	atmosphere	that	climate	magic	balcony	tour	hospitality	spot	staff	hike	meal	way	list	stay	experience	share	animation	air	thing	what	Houston	post	yourself	city	joke	taste	glimpse	day	nightlife	panorama	growth	beauty	basil	dinner	he	democracy	journey	effect	level	protection	art	quality	peak	
store	sleep	it	luggage	basil	some	information	
clean	they	weapon	box	basis	home	purse	apartment	3	tank	gun	window	it	ocean	
allow	radical	he	I	access	they	ISO	tourism	Parenteau	guild	people	matter	you	church	government	option	military	critter	Monotheism	US	pc	port	increase	provider	room	visualization	us	her	stays	tourist	fisherman	rider	Americans	visitor	xml	developer	user	boy	man	this	creator	harmonisation	account	member	subscriber	bann	it	decision	number	Glenda	reconstruction	foreigner	operator	Tories	she	Rona	
space	inch	
remember	machine	Bush	he	name	George	something	Minister	image	time	cost	family	she	dog	dessert	what	bet	everything	it	trip	doctor	place	that	expression	preoccupy	you	I	face	aim	they	
value	transaction	series	deal	Hub	option	life	customer	plant	level	
rule	Sea	area	Bank	830	possibility	
stop	treatment	outrage	murder	newspaper	support	they	round	injury	bombing	kid	plot	it	9/11	record	ad	broadcast	procrastinate	procrastination	he	she	you	harry	side	investor	rubbish	
attach	draft	version	revision	letter	sight	leg	paper	anything	line	copy	itself	importance	
sign	declaration	I	agreement	contract	what	document	confirm	that	master	deal	name	guestbook	billion-year-contract	autograph	copy	book	register	will	
step	you	question	it	
cost	thousand	sum	nothing	bunch	lot	bit	much	money	us	£	€	less	effort	life	$	job	euro	
phone	company	location	
consider	sentiment	it	importance	contrast	invitation	the	factor	being	human	themselves	treatment	change	girl	point	Village	he	project	Dillards	this	repair	doctor	correlation	I	accomplishment	him	modernity	one	result	that	jewel	situation	representative	what	trend	suggestion	writing	safety	rejection	impact	activity	cost	toil	Danevirke	Mongolia	republic	
review	list	request	parameter	standard	meeting	it	website	chart	language	the	application	Contract	draft	process	note	doc	memo	attachment	decision	standing	case	credit	provision	structure	book	letter	
term	some	
control	Ramadi	5	they	mass	market	pattern	amplitude	everything	pest	heart-rate	he	man	access	budget	population	species	strait	
happen	time	alliance	one	kind	what	
check	blog	it	thread	something	contract	email	house	report	listing	site	validity	that	http://www.restaurant.com	price	one	website	tutorial	link	shop	depot	mail	travelguide	other	source	follow	space	tasting	work	puppy	shelter	Lounge	engine	they	place	XF	credit	tire	option	id	War	date	recwarehouse.com	service	these	transaction	positioning	band	cart	each	all	
understand	anything	this	reality	weapon	it	Arabic	difference	landscape	all	intent	that	philosophy	risk	plight	what	text	issue	reason	process	service	future	processing	task	transformation	implication	translation	cause	language	connectedness	english	effect	anxiety	interpreting	why	structure	world	problem	vagary	message	
level	I	
sit	pad	
continue	work	education	dialague	crap	success	block	walk	fight	patronage	tradition	struggle	path	improvement	programme	vigilance	story	
email	I	name	verdict	you	we	Tourist	copy	information	friend	they	me	
buy	bs	gun	item	call	one	pass	crude	oil	apartment	thing	virility	clay	laptop	another	wheel	worm	wheat	ticket	Color	color	copy	hamster	PS3	ps3	material	toy	some	silky	cake	snack	food	pet	rat	cleaser	Europass	tour	souvenir	dvd	grocery	tweezers	baby	vehicle	car	anything	700	oblivion	lot	bag	somethin	card	cookie	set	it	half	dinner	animal	happiness	meal	supplement	fish	ringneck	they	camera	sundae	deal	instrument	"	phone	weed	sausage	jacket	computer	bottle	paper	offset	that	shoe	them	box	broom	quinoa	book	much	bun	postcard	dress	percy	ice-cream	product	house	gatehouse	part	need	
commission	Mike	L'Enfant	portrait	designer	
staff	CPA	
close	point	way	door	newspaper	rank	bottle	eye	deal	gap	
light	it	room	fire	hair	night	hundred	cigarette	everything	cigar	
project	strength	
thank	god	FERC	you	all	Zone	Crepes	Ana	Doctor	Bowtie	I	plumber	he	bonino	commission	rapporteur	goodness	mister	member	mrs	she	
power	cake	
force	those	governor	hand	confrontation	you	window	she	it	all	him	yourself	he	decider	Austrians	
free	hostage	Cuba	euro	Bosphorus	
visit	India	country	family	uncle	mosque	Houston	daughter	Nice	website	dept	we	board	US	folk	law	England	Rome	place	Fujairah	temple	you	U.K	London	Dartmouth	town	kitten	island	that	location	restaurant	Ireland	showroom	Anna	facility	Mia	Office	Automotives	President	page	school	people	Gardens	Tech	server	List	Bank	office	Art	area	Olympia	Athens	festival	Vigie	York	States	University	Nantucket	parliament	she	Kamchatka	show	region	Germany	
offer	way	choice	hand	seat	story	k	comment	lunch	that	rate	help	opinion	job	range	day	they	it	insect	beard	service	variety	facility	Package	refreshment	taste	food	transportation	card	sale	living	crafter	apology	bang	package	manicure	ticket	portion	dog	expertise	lesson	insight	possibility	contribution	finding	right	hour	cuisine	course	tour	information	flight	parking	ship	prayer	solution	version	couple	product	cross-section	tile	anything	amenity	work	flowerpot	sacrifice	thanks	blob	he	one	prospect	term	license	metaphor	incentive	opportunity	relief	something	script	euro	garden	
speak	tongue	English	Japanese	language	French	it	look	moses	yiddish	english	nothing	word	Russian	
study	helicopter	response	development	butterfly	gambling	degree	school	movement	factor	art	mathematics	way	history	adaptation	anatomy	group	symmetry	physics	them	ballet	law	system	economics	form	geography	fresco	dragon	he	it	indicator	humanity	place	design	literature	separation	
head	Islami	unit	way	grid	Osama	
eat	lunch	minister	grandma	game	they	fish	offspring	cactus	food	bread	meat	brunch	it	potato	rabbit	spray	yoke	feed	hay	all	grain	lot	pho	cuban	place	cream	anything	kind	each	much	loaf	insect	mouse	dinner	bowl	that	some	nothing	bun	chicken	beef	mouthful	marshmallow	ice-cream	helping	economy	meal	
base	decision	exhibit	language	some	amendment	
bring	stability	story	memory	oil	commander	evil	it	some	letter	version	we	something	pair	predator	mind	success	unexpected	regime	Syria	Russia	reason	she	lunch	they	evidence	he	kitten	someone	clothing	sort	horse	car	dog	wife	customer	bottle	cash	cleaner	model	much	book	card	food	piece	peace	two	form	shame	future	wealth	I	son	light	strength	reminder	attention	material	sample	clock	luck	influx	child	flavor	concept	people	corner	provision	ice	money	measure	outside	dinner	mentality	israel	steel	box	haze	proposal	result	reassurance	smell	branch	crowd	subject	mass	hitler	anecdote	fleece	that	import	agreement	faction	best	shift	reform	
walk	I	block	dog	hour	store	guy	
plan	what	attack	event	war	trip	holidaying	breakfast	shitload	action	number	coordination	series	
read	some	book	blog	play	letter	what	signal	they	information	it	something	name	material	this	Declaration	article	email	story	which	message	answer	label	package	chapter	bio	site	downloading	review	menu	reviews	contract	Proxy	thing	question	description	column	Shandy	idea	thought	newspaper	speech	that	file	edition	six	sound	study	section	account	feature	work	regulation	dictionary	passage	poll	
face	moment	which	fallout	dilemma	retrial	obstacle	failure	it	drive	that	attack	Gulf	cost	I	issue	Street	lot	pocket	fine	ire	penitentiary	problem	sentence	river	wall	member	Virginia	constraint	team	rack	what	mount	darkness	zion	each	us	choice	threat	shortage	champion	challenge	
meet	obligation	requirement	child	Sufaat	who	demand	he	she	Dave	objective	you	guideline	increase	event	need	deadline	convict	love	LAURA	rider	hamster	other	I	sister	Nigel	that	Jason	Dr	dog	pocket	office	time	girl	him	advisor	parent	Rachel	expectation	dignitary	finalist	husband	linguist	eye	me	predecessor	wizard	lord	either	Quinn	number	chap	fate	commitment	brother	music	they	assault	man	Kurtz	stranger	target	Auguste	wife	Hitler	Mark	
return	you	fire	car	e-mail	application	overcharge	which	greeting	favor	money	it	copy	love	unused	government	America	count	customer	notebook	they	coverage	grandmother	one	
hope	which	that	one	true	
receive	food	discharge	mark	wound	weapon	child	ten	payment	briefing	stipend	training	letter	fx	email	request	amount	report	it	message	visitor	draft	commitment	invitation	amendment	access	invoice	option	feedback	part	communication	boost	benefit	Medal	cheque	treatment	$	dividend	that	thousand	barrel	dime	offer	one	point	award	scholarship	lot	kind	call	service	information	queen	review	certificate	bill	present	some	e-mail	this	transmittal	Alert	%	material	ambassador	Prize	Ph.D.	coverage	deal	support	attention	vote	refusal	fee	donation	Polaroid	average	compliment	degree	nomination	we	news	representation	drink	answer	intelligence	work	fund	invite	care	assistance	praise	pay	£	app	audience	investment	criticism	distinction	
list	all	manufacturer	transaction	act	program	place	cruise	process	one	number	this	company	priority	state	statistic	event	source	outcome	Shakespeare	
better	performance	
pay	family	bill	he	more	attention	k	we	fee	amount	invoice	premium	Transwestern	everyone	debt	price	buck	someone	respects	proportion	double	500	it	800	lot	that	$	dollar	I	balance	cash	toll	much	what	penalty	rate	custom	duty	200	something	£	homage	taxis	euros	CUC	tax	you	woman	man	salary	benefit	tribute	expense	
house	militia	ant	field	mill	orbiter	
case	helicopter	target	
create	job	condition	state	rage	scare	strife	ground	headline	standard	list	fund	name	invoice	climate	reality	structure	security	engine	one	demand	inequity	service	opportunity	kind	layer	sump	rainbow	amount	energy	temp	proof	vacuum	world	that	website	class	constitution	combination	cocktail	drink	it	wikiHow	value	instruction	awareness	enlargement	atmosphere	impression	numbness	change	rave	glow	language	many	mess	group	grid	bond	sql	query	definition	page	link	copy	template	file	microsoft	field	level	category	account	bureaucracy	range	relationship	work	password	advert	chunk	order	way	union	effect	centre	rift	specimen	alphabet	
view	it	they	up	destruction	US	war	history	collection	datasheet	data	all	component	timing	issue	economy	reprieve	
water	sprout	cutting	rose	
turn	they	400	foreigner	$	sound	clock	e-mail	attention	18	modem	it	month	temp	that	tv	light	dream	way	I	everyone	table	Shiites	reign	strip	21	them	head	himself	hair	boat	crowd	area	conversation	language	oven	manuscript	work	question	television	picture	back	autofiltering	smile	message	black	cycle	poor	edition	tide	
begin	period	work	step	disintegration	job	research	phase	process'	process	retreat	conflict	game	mind	mist	net	that	race	life	career	affair	
experience	some	snow	sense	time	death	pain	rudeness	that	decrease	form	decline	boom	book	kind	process	revival	training	problem	disaster	improvement	dilemma	
add	lot	entity	message	item	it	compliance	rule	representation	rep	language	name	semicolon	word	clause	charm	GW	comment	info	threat	plaster	mud	plant	water	betta	aquasafe	mate	that	interest	drop	maker	nitrogen	insult	something	extract	boarder	value	template	change	address	service	flexibility	feature	link	entertainment	Protector	mineral	salt	splash	sourness	them	chemical	aspect	element	Hall	complication	gender	character	connotation	extra	cheese	anything	restriction	holder	milk	cocoa	cup	little	fruit	field	list	html	metal	security	information	category	question	particle	system	option	
deal	blow	meal	judgement	
file	answer	request	letter	paperwork	motion	suit	name	opinion	complaint	
form	cell	shape	opinion	family	unit	egg	rain	thing	colony	Area	basis	bush	spiral	callous	impression	link	friendship	letter	part	ring	moon	republic	network	generation	
book	ticket	room	deal	leg	crossing	car	reservation	which	flight	cruise	lesson	accommodation	
run	aspect	interference	it	nx1	biz	compressor	plant	gas	work	spot	score	restaurant	place	most	buck	type	Lebanon	id'	cafe	CPA	blog	business	eHow	article	discussion	East	empire	show	he	risk	hotel	hand	window	surplus	deficit	school	
love	blog	neighbor	ya	job	she	person	he	cat	Linda	giraffe	it	animal	cage	riding	Food	that	snake	lettuce	most	they	food	pool	Farmer	way	style	Gallery	people	place	gym	pizza	teaching	roof	you	soup	Cafe	Vetri	zoo	location	Boston	sandwich	labyrinth	coffee	Bowtie	car	experience	hair	roll	France	champagne	Script	guy	everything	fact	atmosphere	feel	meat	environment	bit	website	stay	city	costume	book	slang	we	challenge	Shakespeare	colour	brand	
line	it	
play	brinkmanship	hockey	version	Pursuit	golf	sport	song	it	chess	emperor	masquerade	couple	part	game	cod	card	movie	football	music	Ahab	that	Wii	D	piano	softball	role	mah-jongg	lot	Quidditch	quidditch	Joker	record	joke	Shakespeare	Adam	servant	concert	he	Benoît	inmate	
hand	gift	leaflet	certificate	victory	shirt	it	hairpin	job	mop	box	
live	life	dream	year	mile	door	lifestyle	moment	
price	performer	entertainment	Derivatives	
order	food	chair	that	it	firm	bus	appetizer	fries	water	wine	military	they	pork	platter	dish	steak	meal	few	postcard	5000	slice	what	taco	screen	furniture	dress	gown	headfone	part	out	Loretta	representative	party	seed	hamburger	lunch	table	stay	
provide	security	intelligence	motivation	entertainment	anyone	infrastructure	schooling	$	Moussaoui	support	value	sampling	that	process	focus	assurance	analysis	update	detail	stream	answer	means	thought	we	example	question	summary	contact	link	guidance	degree	document	I	testimony	clue	you	service	Abby	food	shrub	shade	assessment	evidence	wife	cancer	cover	subsidy	plenty	top	cafe	ray	source	care	material	request	group	one	massage	version	preference	portal	session	competency	information	access	insight	judgment	finding	home	people	compatibility	user	safeguard	video	estimation	these	air-conditionting	meal	transportation	connection	environment	opportunity	nutrient	word	view	way	series	data	point	location	remedy	compensation	guarantee	distraction	text	choice	model	schema	us	impetus	capital	coordination	%	performance	insurance	regulation	benefit	he	milieu	education	protection	route	Europe	percent	instruction	leather	
seem	what	much	
field	response	
talk	peace	son	sh*t	parent	they	she	you	time	us	mathematics	circle	head	what	nonsense	it	
point	thing	way	this	feature	contingent	get	significance	lack	
send	reporter	Posada	troops	this	woman	he	skater	child	Hindi	copy	bomb	message	cyanide	that	specifics	list	agreement	report	it	resume	document	paper	invitation	dollar	update	card	mailing	draft	version	you	spreadsheet	curve	which	response	invoice	they	application	set	memo	attachment	email	someone	letter	info	delegate	comment	instruction	rate	text	mist	money	flower	phone	number	student	customer	dog	mechanic	we	graphic	wife	stuff	something	team	gift	paragraph	annex	one	friend	note	question	papers	data	suggestion	picture	story	price	Gloria	specimen	le	thing	she	servant	ivory	people	invite	baby	species	emoji	manuscript	Jesus	colony	
end	occupation	life	crisis	violence	it	attack	that	year	friendship	line	career	
follow	notion	ceasefire	lead	example	trail	instruction	probe	leader	pattern	review	price	path	Theory	flight	development	mission	direction	strategy	sign	I	rule	site	link	money	talent	conviction	paper	literature	tutorial	approach	model	aspect	order	resignation	traveler	him	practice	it	event	River	contour	system	guideline	end	completion	meeting	rump	drift	lunch	man	Stillman	sea	proposal	she	they	majority	this	step	condition	enlargement	crescendo	creation	accusation	breakup	he	effort	sequence	2003	date	transition	fall	
show	progress	he	evidence	bravery	connection	copy	kid	revision	apartment	change	you	session	chnage	coordination	response	picture	attention	thing	passport	mom	VISA	something	interest	color	that	sign	hotel	I	car	option	nothing	number	anything	work	flag	what	horseman	affection	it	$	stuff	arm	grandmother	location	advertising	Paralympics	performance	track	body	tourist	vulnerability	side	nature	approach	leadership	lapse	respect	lot	information	content	page	outline	hierarchy	man	inclination	possibility	strand	thorn-tree	abnormality	all	list	table	item	weakness	debate	we	ignorance	smile	tooth	city	two	data	street	position	they	good	lack	six	level	guilt	link	variety	bar	limit	
state	it	Topack	phrase	note	which	much	xml	importance	
start	process	one	draft	step	fund	group	which	project	game	it	filter	tank	biting	business	ballet	job	war	hose	outfit	forum	page	list	trip	file	care	me	remilitarization	side	city	seed	flirt	conversation	system	workday	thinking	hammock	opposition	novel	most	career	reaction	
report	this	interception	charge	they	failure	defect	people	nightmare	activity	preference	form	experience	wisecrack	which	story	breach	thunder	that	
include	member	account	minority	Syria	rumor	control	plan	doctor	suggestion	supporter	interview	he	info	change	Renee	definition	draft	advocate	product	Austria	division	proposal	provision	item	transaction	all	notification	principle	html	vice-president	funding	spacewalk	attempt	shifting	cod	shrimp	love	chess	Guards	holding	Tarawa	secretary	two	piece	system	sit	Festival	number	space	alcohol	fever	share	caveat	correction	page	hca	Jerusalem	Drew	exaggeration	participant	range	centre	peroxide	vodka	specie	Bangladeshi	Polaroid	effect	native	driver	thing	chore	task	step	examination	title	work	panel	Ghostbusters	simulator	field	quantity	that	reference	component	record	capability	Access	one	accessory	name	city	data	notion	incentive	18	opera	right	damage	they	detail	following	fund	content	SME	exchange	counterfeiting	study	country	freedom	limitation	food	bloc	trade	problem	Kelly	rates	Russia	United	scene	fiction	Frédérick	book	collaboration	Hamlet	Shakespeare	monument	performance	Richard	line	Romantics	Francis	play	warranty	his	information	curse	ambassador	Seychelles	unit	letter	woman	stoplight	track	Edward	Rich	time	
ask	Bush	I	he	Terry	Musharraf	she	question	intelligence	Shanna	they	official	everyone	anyone	yourself	George	people	mom	one	you	that	lot	greeter	thing	girl	person	Pomper	Rod	Doug	Stinson	student	this	help	agent	Express	what	President	friend	service	him	reader	government	taxis	teacher	them	who	nothing	Ginny	Percy	boy	Norwegian	life	guess	ron	alms	leave	Mweta	Bray	idea	commissioner	commission	state	
keep	effort	Musharraf	himself	it	blood	contractor	expense	allocation	she	line	mouth	powder	dough	you	discussion	Bobby	heat	Transwestern	I	they	light	power	Jerry	body	name	water	back	hoax	outsider	F	article	copy	note	mirth	track	myself	head	parakeet	window	plaster	job	he	horse	tank	cage	gun	that	cost	eye	rabbit	chicken	one	room	contact	leg	door	promise	comfort	privacy	weight	car	business	which	kid	flow	we	veggy	thing	out	dog	number	peace	most	level	work	cichlid	kebab	cold	Qaida	project	market	talk	wallet	them	hand	strap	me	Carroll	lot	soil	prank	dialogue	everything	all	simplicity	bird	mouse	feces	can	mind	cat	face	time	hold	hat	beat	lip	draw	identity	appearance	native	notice	word	standard	question	declare	MBA	us	transport	rise	spotlight	memory	object	fleet	
question	service	Kerry	technician	appearance	world	motive	Auster	circumstance	contribution	other	
feel	looser	emotion	what	spirit	air	yourself	body	warmth	meaning	feeling	obligation	relief	superiority	it	benefit	she	they	way	need	pain	anything	same	bone	edge	glove	somebody	sense	which	urge	he	slenderness	I	belong	presence	spectator	surge	noise	pulse	connection	impact	
put	block	fetishism	pilot	number	that	vet	information	Israel	detector	guard	paperwork	it	this	mayonnaise	you	box	we	he	steer	agreement	worksheet	facility	metering	message	group	they	stop	I	cursor	stock	focus	nose	Iran	dollar	tag	pair	camera	mouse	animal	dongle	rein	rubber	application	wiring	clothes	chain	faith	water	conditioner	heater	tank	hand	maximum	rock	something	both	piece	rat	leash	stirrup	weight	she	girl	egg	solution	nail	quality	horse	money	heart	need	hair	deposit	foot	label	yourself	lab	Bodhi	tire	everyone	hour	product	thing	show	campaign	description	buck	gorrilla	bottle	sauce	time	bowl	food	life	generation	phone	them	cycle	chip	arm	colony	masculinity	browser	military	basil	smock	mark	mind	system	amount	donation	who	story	regime	elbow	book	finger	make-up	coat	Shinza	board	glass	head	spell	check	good	uncertainty	tea	scheme	negotiation	pressure	limit	difference	sunglass	£	corslet	
let	's	anybody	dog	this	head	he	I	you	they	senator	we	license	s	California	water	mind	cat	it	she	meat	us	snake	military	entrance	Gracee	picture	customer	old	child	man	then	room	that	everyone	leader	Canon	Hamas	friend	smog	Germany	me	them	scientist	soil	Dobby	quality	chain-gang	fire	thing	Mackie	one	bellow	hedwig	come	harry	i	anyone	world	spending	presidency	lobby	
change	name	subject	group	wording	language	description	mind	lock	it	procedure	day	number	situation	ip	anything	US	citizen	view	perception	face	residence	job	room	surroundings	station	filter	film	lane	process	ppl	price	level	tire	lightbulb	worth	that	hand	address	text	habit	thinking	clothes	ending	policy	design	flag	letter	value	flavor	layout	caption	setting	information	property	formatting	mode	programme	record	money	password	color	nationality	religion	this	nothing	structure	decision	
leave	6	area	60,000	Washington	Guard	fact	case	homeland	port	Bush	house	person	message	trace	downtown	Houston	mail	lou	voicemail	town	module	comment	remnant	that	armature	enviroment	it	dock	restaurant	hospital	school	School	door	country	kitten	Westmoreland	Americans	they	visitor	egg	jar	fry	note	nail	customer	horse	2	stone	flower	number	lot	salon	look	he	slice	hammer	I	can	we	lock	which	Allawi	section	Street	Iraqi	choice	soldier	yourself	you	land	people	damage	organization	group	Org	employment	lifehood	her	ruin	them	green	one	farm	boat	ship	church	minute	Łódź	car	elevator	article	document	oil	station	room	Hogwarts	apartment	mouth	neighborhood	city	parent	set	chicago	wharf	africa	England	crack	interpretation	Quinn	wealth	parliament	space	she	matter	imprint	disruption	legacy	service	bulk	bed	building	trial	mark	EU	Spain	citizen	much	party	place	Sicily	
name	leader	other	general	El	lab	company	that	Justice	name	it	man	something	W.H.S.	replacement	he	Mario	Isabel	one	Kreyol	value	OrderValue	xml	%	image	which	William	
number	he	
where	those	
last	time	min.	less	hour	year	
tell	you	IPS	States	truth	something	reporter	daily	story	we	girl	she	I	right	judge	interrogator	authority	lie	he	it	what	that	they	how	driver	official	rnr	percentage	agency	Planet	George	Republicans	date	process	everything	everyone	price	guy	friend	reason	'em	thing	pitfall	bs	total	person	lot	name	wrong	Iraqis	Clinton	space.com	House	other	ceremony	val	supporter	yourself	me	joke	us	storey	Post	number	News	fucker	recipe	son	much	Neil	furious	Daniel	people	shahar	unimaginative	this	let	ron	browser	who	nothing	one	lady	dursley	afraid	crowd	show	Mundo	
here	conversation	
help	child	Muslims	Palestinians	they	we	return	Red	Mr.	you	coalition	California	car	I	chance	Enron	employee	Californians	friend	she	hundred	Philippines	stupidity	someone	animal	hydration	it	customer	people	dog	million	feeling	us	Montalvo	kid	poet-turned-fiction-writer	them	magic	me	coordination	cause	fred	heave	he	well-off	manufacturer	farm	
please	everyone	collector	public	he	
service	island	debt	
even	score	
find	news	way	performance	power	post	cache	citizen	replacement	circle	they	something	piece	time	resume	solution	request	what	stipulation	approach	title	policy	number	agreement	gtc'	response	update	letter	guy	interest	form	conduct	sense	food	information	that	alternative	place	yourself	this	strain	alteration	you	balance	character	he	woman	themselves	Afghanistan	Ocean	States	one	work	mouse	office	school	source	three	bird	restaurant	sort	izakaya	hotel	page	cafe	pet	it	tour	company	get	room	location	same	spot	anywere	baby	job	dog	selection	Stephanie	home	Janice	dentist	wanton	store	parking	she	mechanic	NDI	staff	pea	car	ride	someone	key	do	table	Flyers	Dr.	thing	people	deal	accommodation	tire	lock	anyone	excitement	fix	link	info	phone	website	these	music	band	raincoat	feather	anything	photographer	guarantee	meaning	purpose	term	worksheet	picture	story	which	help	girl	lot	agent	service	fodder	joke	mix	evidence	equivalent	us	answer	brother	understanding	connection	them	resource	museum	deli	kind	bar	charm	land	more	screw	box	team	snitch	behavior	nothing	translate	I	carpenter	value	file	name	reference	husband	notebook	seat	faulkner	heart	paradise	secret	path	we	somewhere	thought	augur	any	harry	success	correlation	effect	delight	composer	skin	spirit	fortune	wi-fi	combination	pattern	route	himself	itself	transition	
new	nothing	
call	himself	Chernobyl	bluff	Bush	they	US	Ismat	you	I	technique	he	503/464-7927	Jeff	Ben	Giants	grandmother	meeting	Richard	gelceutical	company	it	President	whom	BOWL	whatever	611	order	embassy	Bob	trainer	Office	vet	veterinarian	what	farrier	bloke	Matt	HEATING	service	Doors	store	Madrid	manager	guy	people	business	reception	staff	time	desk	hotel	she	em	Bud	Excel	salon	school	dominos	Jersey	representative	office	number	assertaion	plot	atty	Mark	device	Canon	we	issue	thing	police	tropics	themselves	me	heat	destruction	organization	saccades	inventor	translation	wedding	Semaine	that	the	Poet	character	theory	Opus	staccato	sentence	Cowboys	shot	selfie	master	T'ho	T-town	Capital	effect	Albatross	friend	Museum	reportml	entity	who	attention	Virginia	operator	problem	fitzsimons	Mweta	get	which	i	agency	one	vulgarity	Shakespeare	
need	FDR	someone	what	attention	starvation	unity	curve	data	that	rest	info	help	who	thing	I	price	some	more	anything	response	information	copy	it	approval	answer	plan	documentation	counsel	gas	way	interviewer	group	incident	insight	structure	power	she	assistance	money	filter	skimmer	light	stable	direction	cage	horse	pair	coal	cleaning	advice	medication	home	socialization	scooping	lot	place	company	dollar	cater	specialist	soul	one	kind	address	car	jar	they	seal	part	work	truck	grinder	business	15,000	base	space	lawnmower	change	id	shower	something	idea	lamp	source	suggestion	re-start	he	contractor	care	family	excuse	background	passport	love	training	flight	visa	air	broomstick	discussion	shade	plenty	right	control	english	definition	report	infrastructure	you	ambulance	quill	investor	strategy	cutting	action	model	equivalent	access	profile	loan	level	surgery	
give	certainty	entrée	response	money	little	permission	eye	sanctuary	service	insight	damn	lot	email	president	time	credence	it	savings	key	Enron	room	indication	that	year	call	some	#	password	sense	$	price	access	lease	update	birth	above	invitation	chair	recommendation	reading	barrel	differential	notification	detail	right	credit	control	chase	answer	hope	more	power	consent	vote	advice	name	notice	address	rein	interview	cancer	declaration	leverage	pair	immunity	warning	hand	list	opportunity	information	shine	piece	care	fight	discomfort	lifespan	way	info	idea	home	hunt	they	treat	place	command	fluid	water	bit	rice	problem	territory	number	choice	heat	ray	hint	kind	hug	shot	support	receipt	dish	I	picture	chance	warranty	bees'	gift	crap	test	range	description	quote	ride	a	opinion	dollar	estimate	try	plenty	experience	star	liberty	car	tip	deal	fact	ton	good	jar	review	around	12	feeling	ahead	cat	card	look	pricing	deposit	batch	refund	explanation	plate	discount	rating	date	instruction	alternative	phone	half	%	action	reference	penny	yell	day	thought	point	performance	example	diamond	option	11	couple	guide	lack	charge	heart	bang	prestige	all	observation	clue	amount	mine	darn	massage	treatment	solace	drop	edge	identity	lecture	priority	something	injection	news	data	talk	glow	schedule	leg	one	stuff	context	intention	space	shove	act	conversation	boost	break	start	you	orbiter	cake	smell	shrug	obsession	think	mark	interpretation	ticket	lunch	he	word	amusement	sound	slap	shock	sandwich	comfort	illusion	contact	screech	letter	secret	future	floor	attention	sensitivity	aid	shorts	faith	appointment	verdict	flip	alphabet	lift	scream	present	what	work	tug	harry	squeal	light	tap	stare	copy	love	glance	show	post	scent	glass	rise	impression	role	consideration	quality	peanuts	tool	business	intensity	clearer	nationality	declination	allowance	Italy	plan	
place	Karzai	Sara	sign	toe	hand	one	paper	cursor	he	it	order	I	advocate	link	element	combination	rectangle	personnel	chicken	somewhere	snitch	grain	him	they	reliance	player	blame	pressure	
look	deficiency	family	information	way	record	he	dress	operation	ascii'	it	upkeep	Bray	window	agency	check	Quinn	
come	EB	way	time	$	salt	home	
want	terrorist	anthrax	sign	Sue	I	it	tractor	mom	people	they	default	what	you	one	we	6/1/01	deposition	child	route	program	much	article	protection	gas	motto	that	answer	steak	something	iPad	e-reader	some	attention	stall	glue	feel	everything	dog	baby	reliable	leg	he	cat	bird	boy	tourist	seating	horse	food	haircut	more	burger	lesson	dish	$	she	price	miracle	doctor	checkout	weapon	power	copy	way	best	company	chihuahua	island	pet	easy	money	attorney	glass	pizza	Israel	box	NATO	alliance	someone	take	berthage	them	word	knot	whatever	increase	anyone	cupcake	product	time	view	report	lunch	regime	force	excuse	bottle	drop	farmer	thing	art	
people	bank	
work	themselves	hour	bug	way	consumption	muscle	angle	%	deal	transaction	it	that	wonder	aspect	Olympics	joke	one	scene	retro	Kipling	compromise	
use	bomb	it	lack	tactic	position	pseudonym	contact	evidence	card	consulate	soil	compound	Wikipedia	religion	gas	expression	ambulance	child	Embassies	weapon	dryer	anthrax	company	cropduster	word	symbolism	school	box	call	side	tool	WebLogic	BackWeb	password	line	file	kenneth.lay@enron.com	address	help	logo	download	volatility	formula	date	function	amount	attach	form	situation	knowledge	name	tradename	example	information	id	number	button	this	knife	comp	code	helicopter	technique	phone	mantra	strategy	model	that	disaster	death	magic	fund	wmd	recovery	rom	replacement	exposure	job	coupon	co2	kind	pan	cleaner	pledge	Cloth	softener	dongle	they	rein	camera	way	icing	visa	metro	GIMP	b	surgeon	connection	wheel	energy	cage	one	uth'	bulb	type	burst	discretion	aperture	service	propane	cutlery	tooth	leg	wight	mvb	tank	thermometer	bbq	vial	room	method	Family	PJC	grounds	product	firm	guy	spoon	Roofing	Flowers	drill	FusionRetail	anyone	utensil	any	piece	site	diplomacy	pressure	%	collateral	year	format	spreadsheet	Encarta	LTS	shuttle	feature	France	parcel	photoshop	supplement	Travelocity	genesis	ZebraKlub	Irrigation	Electric	Futures	he	Gmail	opportunity	drink	price	engine	agent	you	Birdies	Bridies	hand	treatment	cream	salt	joke	washboard	tie	detergent	vodka	skittle	filter	flavor	T-shirt	eye-tracking	tablet	test	them	object	borrowing	principle	Fusca	Y-tong	spectrophotometer	emission	scope	microtome	most	license	revenue	proceed	banner	theory	emails	microscope	accelerator	account	fame	IE6	which	aspect	VisaCuba	caution	park	status	basil	elevator	Luminol	tube	grammar	letter	oh	language	newspaper	second	broom	stick	snitch	implement	quinoa	measure	category	correction	notation	something	stuff	recording	netting	sheet	case	sugar	oil	chemical	mint	ingredient	litter	outline	grid	typewriter	owl	ball	galleon	adox	ansi-92	statement	distinct	clause	html	content	microsoft	component	query	field	area	combination	variable	standard	excel	count	nz	capability	character	alias	command	motion	measurement	freedom	tag	data	schema	handle	effect	vocabulary	Facebook	fungi	trademark	weight	process	pages	email	link	string	what	page	sample	talent	internet	much	device	incident	timber	grouping	venue	beam	provision	waste	branch	antenna	
up	temperature	answer	
take	deposition	place	care	friend	Afghanistan	uniform	eye	office	Bush	line	boast	advantage	cue	look	toll	casualty	part	job	work	gun	action	claim	metaphor	priest	Europe	longer	we	course	step	boy	company	Ric	deal	this	it	language	much	Michael	pool	sweety	assistant	minute	exam	test	value	more	Monday	time	whatever	couple	I	you	situation	moment	one	class	project	someone	day	generator	responsibility	shelter	seconds	idea	effect	name	opportunity	minimum	seat	stock	life	direction	retreat	Potidea	any	precaution	curse	photo	mouse	cat	she	bit	wheel	film	bag	space	wife	shower	bus	he	horse	ribbon	husband	stuff	they	exit	right	hour	flight	pic	pledge	cruise	picture	pot	charcoal	pre-killed	kitten	leash	tour	boat	leg	ray	radiograph	message	matter	chance	profession	sanctuary	cage	break	dish	food	finger	layer	earthworm	egg	old	ours	lesson	coupon	visit	car	bite	number	case	that	month	16	challenge	debit	money	Frontier	dog	payment	son	fact	kitty	coffee	training	while	Fusion	Cruze	something	courage	buck	min	weekend	worth	puppy	animal	card	heed	salad	price	drive	tire	$	order	some	pride	plunge	try	vehicle	piece	receipt	info	soda	product	approach	screenshot	Americans	risk	liberty	Dow	credit'	Netscape	boyfriend	bottle	bf	myself	section	battery	ride	loach	service	most	light	people	delivery	tip	dislike	beating	walk	in	family	Mustang	role	Bulletin	coat	breath	mother	threat	aywv	her	dilution	position	cab	practice	content	first	me	Freud	Carroll	clothes	him	head	heart	use	study	factory	scope	stand	comfort	decade	girl	lot	video	decision	mobile	Bridge	trip	skytrain	identity	M1	dedication	lifetime	word	note	cart	trash	nap	nature	occasion	oath	fate	player	security	thing	residence	view	sip	toast	turn	flowerpot	pinch	detail	definition	measure	trouble	leap	blade	dollar	man	dimension	reference	initiative	glove	question	furniture	rhino	talk	notice	tidbit	level	beauty	indefensible	handkerchief	Rebecca	mason	hairpin	dobby	roll	glass	granger	photograph	Auster	wallet	side	charge	account	point	year	remark	hand	conversation	gulp	root	explanation	transport	which	form	chocolate	hit	all	need	helm	revenge	theatre	lead	website	data	ship	burden	€	darling	skill	refusal	command	
make	error	I	coup	Iraq	comment	overture	gesture	friend	plan	blunder	difference	arrest	situation	effort	objection	charge	point	road	money	statement	living	advance	progress	attempt	innovation	reservation	bounce	decision	change	thing	determination	trip	Peters	sense	it	call	promise	grade	revision	default	match	matter	they	adjustment	#'s	request	room	arrangement	appointment	type	presentation	claim	lc	heckuvalot	billion	profit	filing	team	choice	packet	$	transfer	anyone	check	connection	he	we	total	generalization	US	all	plenty	reference	captain	role	Lennon	metastasis	Linda	lyric	resupply	country	step	gift	sculpture	boat	noise	image	one	stable	this	best	cover	crew	nightlife	dempsey	people	you	what	chicken	mother	cake	brack	commercial	picture	travel	figure	furnace	version	pet	mess	cat	house	candy	mind	prostitute	yourself	she	war	list	alternative	mop	example	time	cup	order	day	buck	project	recommendation	complaint	visit	rule	art	Ferrari	mistake	repair	sale	excuse	that	NCAA	form	craft	look	cash	drive	pizza	pie	observation	case	cd	bet	support	million	meeting	forum	donation	move	mold	system	poster	chain	statue	convo	tank	stay	life	experience	evidence	announcement	annotation	copy	contribution	$$$	most	offer	strike	material	place	love	ipod	Sense	access	alteration	girl	shadow	landfall	content	peace	hormone	turn	way	player	uncle	fun	joke	audience	vodka	cocktail	bottle	conclusion	end	someone	herself	comparison	light	host	bulk	them	us	either	story	experiment	America	provocation	pilgrimage	Warhol	Marilyn	lot	record	transition	Yucatán	sound	Christianity	jam	technique	pesto	ride	woman	her	him	Glowsticks	glowstick	everything	Vogelaviatiolaps	word	language	grammar	guess	something	proto-language	snitch	game	Frankfurt	constellation	politics	impact	nation	appearance	Rockridge	wai	contact	cutting	cactus	cupcake	cream	repellent	tour	lunch	world	omelette	much	chatter	jab	entry	speech	grimace	pace	Dursleys	writing	page	food	Quinn	breast	bowl	fringe	deal	populace	revolution	demand	start	spot	glance	meaning	pause	brick	exception	regulation	wine	separation	commitment	package	toy	scribble	bit	arrival	fool	conversation	town	harry	drill	dudley	text	note	haste	tunnel	hair	grab	dursley	rock	warranty	modification	representation	position	transport	condition	amendment	use	password	improvement	assessment	a	ocean	finding	problem	message	headline	Winston	west	mischief	Balzac	name	completion	wallpaper	leaf	impression	Shakespeare	adaptation	IMF	collection	shoe	recovery	film	negotiation	division	majority	music	sample	cameo	
like	rule	blog	story	bomb	ability	that	cruise	style	turkey	room	we	resolution	someone	authorization	information	Lynn	this	steer	it	talk	which	way	Bush	MIUI	diaper	I	food	riding	cage	stall	Parisians	answer	shadow	movie	option	comedian	pool	she	more	ale	he	you	trotter	animal	fact	wonton	place	BK	atmosphere	drama	house	a&m	turnaround	shrimp	bacon	brain	music	band	blouse	cow	Movers	Grill	job	guy	type	they	sushi	thai	pie	writing	joke	them	flavor	doctor	me	everyone	freedom	nature	science	sort	sense	flirt	speaker	tanker	what	whatever	Hjalmar	word	sound	girl	book	action	everything	advice	commission	issue	It	
so	job	
get	anything	Iraqis	spanish	Americans	you	he	sense	discharge	I	time	intelligence	supplies	who	judge	gene	hackles	bus	lesion	paperwork	update	this	CRRA	what	woman	test	chance	press	fact	help	it	NetMeeting	approval	they	comfort	stuff	bathroom	message	thing	head	alert	much	attention	up	testimony	scoop	call	education	handle	copy	everything	market	viewpoint	one	guidance	price	look	premium	document	announcement	way	model	minute	fax	feedback	break	idea	name	preorder	software	system	detail	vote	country	email	website	money	information	piece	bill	job	plenty	Capricorn	mail	feeling	period	version	balance	English	sensor	info	visa	laptop	dollar	150	bit	nothing	camera	hamster	ticket	cage	the	pack	skill	buzzing	filter	problem	answer	infection	another	skimmer	gallon	tank	air	fish	titt	phone	same	tv	Xbox	kitten	toy	rat	lunch	coating	horse	something	14	photograph	that	she	point	lucky	advice	bird	dogs	quote	rabbit	disease	python	mom	reptile	rid	boy	hold	snake	treat	standard	pig	female	grade	treatment	box	book	dog	someone	lesson	number	degree	pair	budgie	parakeet	male	soaking	tour	shop	egg	those	balcony	room	window	seating	magazine	opinion	mark	body	guy	hair	tattoo	computer	service	bagel	payment	bag	sunroom	coupon	human	appointment	nail	picture	act	Maids	house	star	motor	rangoon	agreement	food	napkin	customer	inch	car	excuse	square	manager	lovin'	boot	bike	Ferrari	more	highlight	compliment	business	parking	home	$	tire	mileage	order	discount	coffee	estimate	issue	mpg	steak	program	runaround	chair	dish	beer	tile	clothes	laundry	roll	Dr.	deposit	pizza	pie	certificate	result	towel	couch	furniture	deal	out	rate	forkful	reservation	flat	Steven	cooperation	financing	class	feel	friend	word	count	opener	memorial	Korea	page	wife	power	sundae	warranty	aquarium	permit	iphone	all	confused	kind	amount	we	question	a	ass	spaniel	response	download	resume	cash	lot	airfare	releif	weed	some	dinner	morcilla	wifi	iPhone	microdermabrasion	enough	work	view	gift	both	taste	iodine	overdose	laugh	bottle	flavoring	Alzheimer	her	choice	publicity	paper	baseline	visitor	game	trip	opportunity	value	day	fine	space	sunlight	knot	motivation	aspect	right	essence	respect	flower	mouse	oil	man	play	interest	fever	advantage	Harry	signal	tone	sun	protection	mission	charge	impression	independence	Mweta	banish	character	African	contract	people	scar	magic	lucius	data	Paul	intensity	dimension	breath	affair	voice	news	channel	potential	SME	invite	subscriber	policy	relationship	yield	edge	Frank	ladder	
go	activity	way	Virgo	circle	which	while	eye	mile	door	click	home	What	yourself	road	staircase	look	story	
will	dog	
do	anything	what	whatever	any	work	that	it	harm	this	same	much	thing	service	brainwashing	minute	good	more	both	spadework	lunch	laundry	job	deal	story	best	favour	exploring	thesis	ever	everything	investigation	notification	drug	waht	least	dance	mathematics	something	posting	lot	little	operation	effort	damage	hnd	search	course	sort	country	math	sculpting	presentation	stop	show	amount	research	chore	idea	registration	nothing	overnight	yoga	scissors	trot	ray	study	business	trick	change	test	foot	panel	exam	all	heat	photo	wonder	type	re-wiring	baking	favor	I	paperwork	hair	repair	nail	acupuncture	surgery	5000	jewelry	which	stuff	one	amendment	hundred	introduction	impression	bunch	therapy	raincoat	paper	another	cheapest	project	flight	experience	bit	activity	report	wrap	banner	insurance	breakfast	raffle	series	news	flavor	task	needlework	PhD	analysis	magic	Santorum	S&M	other	reading	humor	kind	can	carving	duty	chapter	management	wai	imitation	book	affair	wriggle	justice	stretch	bidding	aspect	penance	he	battle	
have	population	grounds	seat	rights	chance	Jazeera	effect	lot	acquaintance	idea	merit	role	fighter	program	ink	power	that	little	what	affinity	appetite	need	obligation	potential	number	conversation	means	command	training	hand	knowledge	problem	contact	sex	site	service	blog	income	story	skill	demand	business	contender	force	benefit	support	streak	report	much	concern	something	interest	time	way	record	tool	will	multimillion	friend	generation	nothing	motive	definition	collection	more	monopoly	fit	pretext	information	area	GDP	limitation	set	illusion	law	tumor	ambition	ideology	doubt	mission	strain	access	weapon	anthrax	Ames	tie	manual	phd	money	experience	influence	connection	data	commitment	opportunity	title	plan	meeting	question	grid	file	entity	$	2	one	lunch	comment	couple	contract	it	sign	call	thought	Presentation	presentation	in	view	sense	office	invoice	discrepancy	day	patience	theraphy	bunch	you	weekend	threshold	line	this	form	coverage	change	surgery	challenge	which	parent	privilege	grandson	occasion	summer	series	mile	truck	most	sort	book	many	cashout	anwser	machine	initial	Thanksgiving	girl	authority	swap	voice	memory	anything	majority	fun	dad	info	rest	item	settlement	some	protection	button	minute	issue	week	response	option	someone	flexibiltiy	rate	agenda	type	surplus	thing	several	session	ssd	id	suggestion	copy	repercussion	original	everything	conflict	interesting	documentation	requirement	quiz	relative	amount	agreement	difficulty	look	center	delivery	basis	litigation	sensitivity	Brian	Enron	#	kid	sympathy	hurdle	herpes	gash	feb	list	preorder	account	child	hope	family	heart	shot	fund	network	lymphoma	band	reserve	trouble	intellect	Samuel	flaw	branch	control	strategy	link	meowing	misfortune	envelope	herd	depiction	pocket	city	people	feeling	credibility	capability	transportation	schtick	technology	start	room	affair	Yoko	trauma	complex	intercourse	relation	militia	man	exit	soldier	economy	analyze	insurance	member	image	sister	ours	yours	mine	appy	X940	camera	filter	dslr	pixel	dinner	they	percent	kitten	parakeet	fragrance	laptop	kind	piece	knife	slot	hamster	drama	appointment	cm	route	father	phone	video	anniversary	dish	store	doctor	cat	value	spoilage	encounter	reef	powerhead	box	pump	difference	switch	screw	rail	budgie	deal	company	key	seizure	life	expectancy	bond	toy	cage	distribution	corn	breakfast	party	shower	toast	model	auto	function	counter	hazard	airport	French	wodge	male	space	calico	horn	kidney	plenty	minimum	crapload	origin	pic	feature	feather	color	skin	muff	beard	shank	comb	toe	trailer	suspension	impact	place	opening	point	blue	hunt	bit	degree	puppy	clip	freedom	recommendation	degu	two	diarrhea	website	following	show	variety	waiter	pool	slide	budget	shepherd	bus	month	trip	food	hobby	diarheya	gastroenteritis	blood	Parvovirus	objection	group	reputation	future	loan	snake	environment	instinct	python	victory	any	lamp	bulb	ray	he	ring	pink	choice	frost	killifish	plant	pair	tour	blast	ball	cabin	habit	whole	wife	old	test	acupuncturist	ornament	regimen	vet	possibility	horse	few	study	chiro	repoire	blow	stroke	wedding	compassion	uniform	coat	meal	garden	price	selection	cut	staff	hair	tea	best	sonic	lady	clothes	Chicago	rib	pedicure	John	enchilada	batter	fight	stuff	cake	salmon	temperment	guest	policy	hole	music	ear	I	roll	usual	quality	pleasure	inventory	pain	clue	emergency	light	tail	depth	bug	%	address	back	robe	phobia	pet	audacity	spare	work	studio	leakage	luncheon	tissue	polish	car	sampler	cheese	oil	damage	symptom	team	dollar	customer	school	facility	special	bite	ability	rosette	meat	ingredient	card	animal	equipment	sashimi	result	flake	suv	blowout	we	credit	proof	stylist	warning	return	table	receipt	suite	Soup	date	alternative	expectation	roomful	dog	combo	owner	grease	essay	Tom	coloration	emphasis	interpretation	eye	assurance	margin	sample	approval	20.000	ticket	capital	background	trader	scene	forum	rescue	implication	disease	figurine	catalog	exhibition	rose	impediment	chip	Evo	sleep	zoom	drink	event	cream	formula	dhirea	vacation	fare	exhibit	teeth	complaint	gift	flavor	flower	pizza	console	dentist	review	scarring	loss	window	reason	right	bomb	memoir	rule	rfp	respect	lights	flight	willpower	part	disability	urge	seafood	knowledgement	tight	hundred	project	recipe	screen	tattoo	sue	cockatiel	crush	gun	wifi	she	pattern	hr	over	location	ton	sushi	repair	battery	strawberry	daughter	product	slice	stay	Lobby	employee	shop	dui	structure	Saab	cavity	researcher	explanation	wind	sketchbook	elephant	helicopter	past	history	brain	moment	intake	share	quarter	church	minaret	target	performance	vision	granddaughter	job	storey	ant	strike	cocktail	priority	beast	material	profile	mini-MMPI	chart	article	million	status	admin	advantage	instruction	market	visitor	visibility	orientation	broadcaster	career	resolution	fear	interaction	banner	editor	writer	understanding	take	process	teacher	imagination	demo	rationale	vote	vulnerability	passport	theme	crowd	sensation	signature	yield	habitat	range	visa	cash	dance	atmosphere	shape	marketplace	glitz	tram	sunscreen	climate	temperature	bathroom	dune	@card@	charm	airline	system	community	attitude	mentality	student	vein	soil	basil	mirror	excuse	truth	name	belief	aversion	desire	setting	qualification	pulpit	success	decade	solution	effectiveness	volunteer	legacy	stamp	conclusion	ty	sleeve	beach	pad	energy	infestation	nail	leaguer	body	face	crown	swagger	mind	aunt	grip	companion	end	script	faith	evidence	answer	nick	boy	field	sheet	element	tag	purpose	license	component	functionality	intention	tendency	notebook	ground	air	object	opinion	hoop	enough	duty	genius	weather	con	jam	cushion	cheek	hold	simplicity	fascination	pose	complexion	passion	meaning	bone	passage	collar	jacket	learning	entrail	dressing-case	presence	refinery	monitoring	operation	directive	competence	criticism	debate	levy	floor	impression	vitality	premonition	foot	cover	strand	steak	order	glass	Mussolini-jaw	tone	attention	birthday	house-elf	good	favourite	microsoft	department	wart	theory	cup	chat	penholder	blush	distaste	misgiving	self-confidence	regulation	standard	recourse	guarantee	PCB	load	datum	outcome	responsibility	competency	say	luck	trick	Shakespeare	root	page	representation	dimension	level	condition	crack	squad	lining	timing	appearance	extent	headwater	salary	era	offspring	brother	km	chapel	
be	what	thing	kind	cycle	amount	experience	lot	mathematician	whatever	which	hare	wife	nothing	wine	
