overhear	I	
condone	country	
rampage	Bush	
gobble	secretary	
meld	he	
broach	I	
humiliate	he	
enfurate	that	
displease	husband	
boggle	it	
develope	sub-culture	
adhear	who	
spel	he	
resond	you	
modulate	they	
backpedal	contact	
bure	plant	
ck	you	
co-sign	you	
ok'd	John	
memorialize	agreement	
laud	commissioner	
subside	clamoring	
resurrect	we	
madea	you	
segueway	I	
redefine	they	
militarize	you	
beseech	I	
mobilise	Cross	
sponor	Control	
cookin'	D	
outbid	Japan	
plummet	price	
dishonor	denial	
ive	they	
vacate	he	
portend	trend	
vow	authority	
b.	Ruy	
ridiculize	who	
sculpt	I	
guz	i	
cunclude	someone	
varie$	it	
unde$tood	you	
usee	he	
slither	it	
slaughter	they	
detach	jaw	
trye	I	
walkin	he	
belive	I	
guss	i	
comprehend	I	
refold	they	
regrete	I	
answetr	they	
outshine	flower	
appologize	she	
itemize	they	
pre-screen	they	
purchace	I	
ltake	they	
thouhgt	I	
squirm	they	
slit	intruder	
renigg	he	
sympathise	I	
inflame	term	
predominate	that	
expend	he	
outrank	who	
conrfirm	who	
regress	i	
accecpt	we	
slay	Google	
shiver	she	
recoment	I	
vist	who	
overstate	that	
bode	outbreak	
mismanage	they	
developiong	Google	
aquire	Google	
mimic	that	
undrstood	I	
devastate	Katrina	
enlighten	you	
let'	food	
flatter	it	
plead	sister	
reapportion	step	
smash	you	
typify	that	
weathered	limb	
swab	doctor	
wince	mother	
gladden	it	
oversleep	I	
fizzle	they	
mimick	that	
Know	we	
clinch	we	
liken	Rob	
digress	I	
compress	we	
dub	Matthew	
dwindle	crowd	
collaspe	Hotel	
cultivate	program	
pre-organised	you	
counteract	people	
pointe	you	
gotta	you	
smudge	newsprint	
re-use	you	
bogging	that	
convene	he	
coalesce	swarm	
embody	who	
err	he	
fundrais	group	
curdle	mixture	
lurk	tear	
vouch	he	
gape	hut	
beckon	forefinger	
come+to	he	
jib	they	
conceal	effect	
hoe	woman	
overlap	element	
predetermined	it	
retrace	he	
abate	quest	
stagger	he	
backtrack	Quinn	
implies	this	
destine	he	
lather	he	
extrude	underlip	
nourish+though	air	
suffice	stroll	
toot	horn	
quiver	nostril	
riot	he	
fidget	he	
misunderstand	you	
haule	he	
arouse	anticipation	
doze	who	
snore	helicopter	
collide	he	
relinquish	who	
waggle	she	
throb	vein	
padlock	vernon	
loll	dudley	
sizzle	joint	
reckon	I	
twiddle	fred	
cower	they	
clang	bell	
flare	nostril	
leer	she	
slurp	they	
skim	she	
dials	he	
thresh	they	
pervade	mildew	
scrutinize	other	
quoth	Plato	
sicken	they	
elicit	question	
elapse	time	
glower	Dando	
romp	bachelor	
gravitate	he	
splatter	cream	
flay	he	
slouch	weasley	
exhale	we	
inhale	it	
acquit	court	
widen	gap	
unchange	amount	
subjected	one	
benefited	purchase	
invalidate	India	
unsettle	estimate	
outgrow	bank	
putt	EU	
languish	agenda	
oust	who	
titillate	audience	
observing	he	
adore	he	
overturn	which	
pinpoint	which	
resonate	that	
entice	republican	
trivialize	they	
firebomb	someone	
balk	who	
colonise	both	
degrade	destruction	
narrate	poem	
pique	none	
animate	princess	
reunite	wing	
espouse	Mishima	
delineate	law	
inhibit	that	
scrutinise	council	
entertain	they	
kidnap	guerrilla	
spout	he	
succumb	child	we	
perpetuate	that	
reestablish	they	
sympathize	fundamentalist	group	
libel	Dan	
dread	other	
strut	killer	
pertain	that	section	
unravel	case	
scour	reporter	sunlight	
outsource	US	
permeate	question	influence	
underestimate	observer	nine	
drool	Huskers	Sooners	
duplicate	who	
transpire	event	
harass	I	
lash	Dr.	
swirl	breeze	
officiate	who	
applaud	we	
re-read	I	
graze	sheep	herd	
stump	Bush	
hinder	that	
brim	career	
mourn	he	phoenix	
deceive	he	
hum	wire	
imperil	fighting	
overwhelm	military	group	
renege	Bush	government	
hirier	h=guys	
flatten	they	
bounce	he	
shin	sun	
echo	I	
immigrate	you	
hibernate	baby	
suffocate	egg	
chalk	I	
inspect	he	
giggle	clerk	
reek	unit	
whir	engine	
avail	I	
detonate	guerrilla	
waver	Party	dusk	
poss	they	
waive	Department	
discriminate	which	
revolutionize	it	
crave	I	
dissipate	storm	
shun	they	
weep	skin	
unify	King	
industrialize	nation	
ingest	they	
popularize	Dan	
overshadow	lot	
cheat	I	
capitalize	Łódź	
intersect	street	
intrude	it	
puree	you	
malfunction	primary	chute	
dislocate	shock	
arc	that	
trump	favors	progress	
concede	he	who	
whack	he	
equate	entitlement	
clamour	they	bag	
usher	Harry	
stomp	he	
outstrip	star	ingenuity	
baffle	precision	
perk	face	
taunt	Auster	
recoil	hasid	
gloat	monde	
flinch	I	
signify	record	
taper	funnel	FED	
grieve	he	
blunder	I	
crouch	shape	dobby	
override	that	
enrich	screen	
refill	Dando	
marvel	Bray	
howl	dudley	ghoul	
whisk	petunia	
scramble	he	
churn	sandwich	
growl	hagrid	
sprint	ron	
crackle	wad	
herald	accumulation	
rob	he	
repose	cat	
recline	bone	
quicken	man	
tremble	belly	
jingle	key	
ruffle	she	
bombard	he	
sequester	fungi	all	
standardize	grammar	
abide	I	
dispose	company	censorship	
prioritize	we	
re-establish	report	
incline	China	
engender	innovation	
enslave	that	
spew	Kremlin	
traveled	he	Balzac	
transpose	Balzac	
propel	reserve	
disdain	he	
dramatize	history	he	
hinge	plot	
stoke	villain	
reconstruct	which	
immerse	they	
reaching	intervention	
alienate	Hollywood	
commercialize	they	
dredge	Shen	
cede	Spain	
chronicle	film	
unearth	syllable	
characterise	that	
bust	they	I	
irritate	what	
mutilate	soldier	
flop	most	leg	it	
abstain	who	John	
preach	Jeffs	
evaporate	profit	
formulate	you	they	
revoke	Bush	
disagree	islamist	I	
instigate	Office	
articulate	that	
envision	we	I	
utilize	that	system	we	
morph	we	Google	that	
accelerate	action	
sue	we	Committee	
batter	that	
bleed	Mr.	that	
oversee	population	latter	
overtake	it	that	
recite	he	you	osip	
meow	cat	she	
pollute	they	that	
wed	you	
ridicule	Holofernes	
dung	you	
cement	victory	
envelop	engagement	that	
relay	organisation	
blush	you	
weigh	I	
lick	he	finger	
gallop	I	
teethe	he	
digest	they	ant	
prescribe	vet	he	
rub	kitten	
wag	tail	end	
fixed	they	
reccomend	i	I	
mingle	we	group	
slap	they	hand	
rave	I	
budge	they	he	
bruise	you	
fume	I	
presume	I	reaction	
summarise	Otto	
visualize	Inc.	
underscore	House	revival	
bulk	they	
ply	bus	official	
embroider	they	
fling	they	I	
eclipse	wealth	
picnic	local	
undo	it	
posit	we	reader	
recount	bartender	Nicholas	
garner	you	
wage	Scientology	
retaliate	South	
slant	which	
multiply	G-forces	
peg	way	
impart	which	discussant	
don	thousand	
disintegrate	it	government	
lengthen	line	
devour	Cervantes	Russia	he	
deprive	which	
shudder	Dobby	bush	
confine	you	
dwell	he	
preoccupy	Don	threat	
elude	nature	
rewind	Quinn	
goggle	eye	people	someone	
loaf	I	
murmur	he	
refurbish	they	
recognise	union	
wane	resource	
mumble	he	
convey	smell	
slump	some	
wedge	he	
purse	breast	
cough	vernon	
yawn	fred	
brace	he	
paraphrase	I	
penalise	euro	
straighten	ron	
prolong	it	
broaden	country	
emphasise	group	
envisage	project	
peddle	government	
envy	I	
lament	economist	woman	
motivate	they	
conceive	Balzac	who	
reappear	character	
acclaim	Romantics	
tune	he	
enlist	revolution	
intensify	hysteria	
preside	guard	who	he	
prank	pair	
partition	treaty	
pardon	husband	
wield	who	
sniff	ideologue	mouse	
affirm	Naji	Constitution	we	
implicate	bombing	pastor	he	
testify	agent	Patrick	head	I	
slack	Bush	he	
penetrate	this	warmth	they	
ski	some	
prevail	world	which	citizen	
symbolize	green	shape	
reschedule	he	we	
memorize	card	you	
commence	which	freeze	reign	settlement	
deduct	you	
stink	rule	they	service	
violate	which	you	
swim	we	you	
ward	it	
stab	I	
overflow	toilet	
reap	you	business	country	
nominate	President	Bush	
infuse	travel	it	mycelium	
distinguish	that	I	
excite	I	IMF	
creep	he	
ink	China	
shatter	economy	glass	dish	
zoom	i	
disconnect	I	
groom	you	
pee	she	
qualify	I	they	
dilute	gene	
bark	he	
hatch	fry	they	who	
apprentice	who	
spoil	I	appetite	
rig	they	
scrub	they	
activate	alarm	we	
recomend	I	
tout	inn	
hitch	we	dudley	
revisit	NASA	they	
preorder	i	
strive	you	that	we	individual	other	
cater	place	that	
summon	Norton	
Order	we	
minimize	which	
worsen	she	lot	condition	
melting	cornea	
regain	city	
enclose	reason	
scoop	you	
induce	militarism	
reaffirm	sport	people	
tweet	President	co-founder	
analyse	scientist	team	
encompass	that	which	
encircle	that	
relocate	Franciscan	
salute	inferior	I	he	
germinate	seed	spore	
sprout	root	
dive	she	
forgive	Auster	
rust	fender	
dart	flame	they	dobby	language	
screech	he	
incur	which	
confer	they	perceive	he	
flick	that	she	he	
ache	back	inside	
gleam	edge	
clatter	weasley	
stride	he	
flap	Quinn	
inherit	we	fungi	Carney	who	
pity	he	
complicate	we	
reiterate	who	president	
moor	which	
thwart	poverty	
exemplify	decline	
accede	Bulgaria	
levy	RECO	
co-star	he	
fulfill	power	
revive	tour	I	
spill	which	
weary	public	
chant	Shiites	crowd	
uncover	reporter	word	
realise	government	Americans	you	harry	
confess	Bernard	Lone	I	minister	
nurture	ISI	Oakland	
interfere	neighbour	involvement	it	State	state	
reconsider	Pakistan	they	I	
reopen	who	
censor	we	
invoke	Osama	
leak	FBI	sewage	
offend	I	
retrieve	user	
adhere	you	they	parliament	
resign	developer	
finalize	we	
defy	Winter	Google	picture	that	
slam	it	he	door	
merge	mind	consciousness	it	
embark	pair	he	we	
vault	mission	
neglect	it	he	
endanger	act	modernity	approval	
reimburse	Bush	
void	you	
foresee	you	I	
flush	blood	
claw	they	
hunger	you	
hug	he	
honor	they	
peel	seat	
overcharge	they	
spay	cat	
bait	they	
revolve	world	theme	that	life	
kiss	man	Rachel	
contemplate	Party	you	
hose	she	
exacerbate	result	this	protection	soar	
ferry	that	
carve	you	we	epitaph	
emphasize	it	I	you	
injure	brother	
punch	editor	
resemble	it	he	
committed	ex-husband	
soar	population	hedwig	share	
snatch	seeker	he	
rival	power	
shuffle	Dobby	he	
peer	Fred	
pin	badge	
fasten	Quinn	
gasp	boy	dudley	
crumble	plaster	
embrace	we	he	girl	
glide	shore	flame	
accustom	he	
whisper	harry	
hammer	vernon	
cling	ginny	
mitigate	tax	
dedicate	he	
rose	house	
heap	he	
incite	ambition	
champion	who	
spur	success	
endure	Gov.	Cleveland	that	unity	he	
falter	runner	economy	he	potential	
discourage	this	that	fear	she	
concur	I	you	
circulate	report	air	
flock	who	Londoners	
migrate	citizen	wolf	which	population	who	
invade	Iraq	Saddam	she	water	Louis	
massacre	regime	
starve	you	he	
collaborate	all	who	Shakespeare	Nicolai	
expel	who	they	hogwart	Spain	
summarize	which	chart	
borrow	you	faulkner	Balzac	
terminate	call	license	
depict	which	movie	picture	
govern	that	
grin	they	dudley	fred	
spike	price	
fuck	who	
scrape	they	she	
fade	dissatisfaction	prominence	evening	smile	
descend	Koran	it	who	I	
plunge	they	car	
flicker	picture	recognition	
sneak	rabbit	
dictate	we	that	he	US	
dare	you	I	woman	
amaze	sense	value	I	
spice	they	
dump	they	man	
sin	you	
beam	Winston	weasley	
upgrade	i	
specialize	that	they	who	
proceeding	member	
behave	world	Everybody	I	everybody	being	
hypnotize	chicken	
whip	wind	band	air	
buzz	it	fly	
chew	Quinn	
disguise	that	
knit	woman	
bump	we	he	
practise	they	he	
hover	smell	noise	
oblige	he	
chill	building	
exclaim	he	
safeguard	which	
reverse	fred	
roar	vernon	weasley	
wreck	kissinger	
entail	that	volume	improvement	approach	
deter	that	
pronounce	connection	
died	Waclaw	Hamnet	Shakespeare	who	all	
orient	it	
swear	he	I	
criticize	spokesman	group	you	party	scholar	
loom	war	possibility	apartment	
embarrass	he	it	
blink	he	it	I	eye	weasley	
cite	SPLOID.com	report	international	
disclose	report	I	
cooperate	Hambali	authority	institution	
isolate	who	
correspond	term	tussle	
insert	I	
trademark	McDonald	
compensate	this	he	
intercept	spy	
span	that	McDonalds	
jam	they	weapon	we	
trigger	change	attack	
fuss	human	weasley	
coincide	report	this	date	anniversary	disappearance	estimate	
assassinate	Valdiviesco	
sap	year	that	
restrict	visa	you	
prop	i	
hop	i	rabbit	
forbid	country	god	Association	
rebuild	they	
rally	people	they	Dow	
fungus	egg	
mask	amount	
flip	car	
endeavor	she	
restore	they	
were	we	I	
parade	group	
quit	you	they	employee	
celebrate	citizen	gallery	project	NASA	dozen	
swell	muscle	cassock	foot	
sigh	she	weasley	
merit	who	
confuse	you	
bow	servant	Dobby	
drown	sunlight	
endorse	house	majority	
persist	sun	something	fixation	gap	mosquito	shortcomings	
duck	harry	he	
dash	he	harry	
reinforce	priority	
rage	plague	
populate	we	
reign	he	
assert	he	District	historian	
haul	people	she	we	
subscribe	I	you	people	
bang	they	he	
sponsor	Iran	we	
instruct	koran	Cloud	god	I	term	De	
analyze	it	you	
log	you	user	
dig	I	somebody	petunia	
stamp	dancer	
originate	it	you	he	which	41	hall	
burrow	many	it	rabbit	animal	
attain	you	
imprison	Atahualpa	Church	
cease	pursuit	currency	noise	it	
disturb	it	
boast	Tablet	Hutt	city	
panic	he	
clash	pillow	troops	
flee	people	member	cockroach	refugee	Shakespeare	
layer	you	
insult	they	
beware	non-smoker	
annoy	I	
comply	HANO	YouTube	that	we	which	
accommodate	camp	they	
bury	I	
drift	breeze	they	mind	
disperse	cloud	
admire	he	you	I	she	
spare	you	who	god	
interrupt	Clough	I	
march	they	weasley	Philip	
conform	mode	character	it	document	matter	
mutter	he	Quinn	percy	
disrupt	man	
queue	who	
burden	one	
gaze	he	
polish	you	
situate	which	
overthrow	revolution	which	
blast	which	
characterize	candidate	Navrozov	jacques	
undermine	they	finding	that	environment	term	
manufacture	handful	
fulfil	George	which	economy	
detect	I	Americans	he	
explode	they	one	circle	economy	building	it	bomb	
shout	you	boy	they	weasley	
raid	you	he	
strip	you	death	
forecast	we	
hook	we	you	
allege	lawmaker	witness	Xinhua	complaint	
interface	we	policy	
alter	they	it	that	
trot	he	I	
suspend	States	they	
customize	you	
tame	I	
spawn	lineatus	they	one	it	
impress	holidaying	that	Dr	
tow	roadside	they	
persuade	i	
extract	I	
hunt	police	who	
lecture	he	wife	Abel	
undergo	area	center	vehicle	book	
charter	Lodge	
bare	doctor	
encounter	Fusca	
advertise	you	
broadcast	SNY	that	
wound	he	
shrug	he	girl	I	
lap	he	
integrated	which	
corrupt	inequality	
foster	that	control	
manipulate	he	
dismiss	Sha'lan	he	man	Caplan	
rear	it	
deteriorate	they	health	armament	condition	tie	
hint	they	
integrate	weirdness	that	
condemn	people	dignitary	range	board	we	Thomas	
recruit	he	Vinod	asia	
react	CRRA	we	she	market	cat	authority	president	
overcome	they	FusionRetail	parliament	
spell	you	
devote	you	
consult	Winter	I	commission	
dwarf	bear	
paste	you	I	this	
justify	what	one	they	
consume	they	we	
yell	I	guy	
congratulate	I	
invent	he	you	I	
regulate	demand	you	which	
trace	police	gossip	
exclude	they	
satisfy	i	
iodise	country	
infect	we	they	
tap	he	someone	
surprised	who	
chat	Tatu	
scatter	terror	
brave	he	
intrigue	fact	they	
anchor	we	
gesture	she	
hurry	they	
jerk	eye	
compose	Kim	
retain	democrat	
cloud	surge	
vanish	planeload	it	she	people	dobby	
grip	that	missionary	clash	
yield	election	root	
stem	fixation	many	difference	
scare	we	fear	you	
gear	we	
bid	bidder	they	who	
organize	Barbara	plan	who	
exceed	overcharge	rise	care	he	reduction	which	
toss	Hewlett	she	they	you	Stillman	he	
worship	industry	victorian	
undertake	States	manner	George	project	Nida	I	
scratch	they	hen	bird	
chase	cat	they	you	
melt	you	it	I	brass	
butter	you	
spray	you	man	
string	she	
fancy	she	I	you	
rack	you	
hiss	kitten	she	they	cat	
grill	who	
sum	I	
pride	they	sector	
accomplish	Delight	President	you	man	
occupy	it	Japanese	people	miracle	
surge	it	fear	people	future	
alarm	that	severity	
appoint	Areopagus	they	
dissolve	color	Dobby	that	
sacrifice	you	worshiper	
stroll	they	one	I	we	harry	he	
toast	option	rhodesian	
sustain	we	
pant	breast	
harvest	Arab	she	
flash	eye	
is	that	
pile	we	
moderate	rate	
witness	we	
harm	this	you	that	hypertrophy	it	
constitute	that	it	which	what	who	license	they	
provoke	temper	who	amin	that	breakdown	
rot	you	they	bank	rat	
pale	appropriation	all	it	
verify	this	site	server	
interpret	who	that	universe	study	
mature	they	leave	plant	economy	
interact	you	these	they	user	nature	officer	
relax	back	she	
hesitate	I	we	Quinn	
pound	heart	we	
mold	you	
shift	he	
brush	you	
accompany	who	
charm	snake	
shell	she	
slide	trunk	it	leg	
ease	tension	
buck	you	
unite	Cameroons	
seize	who	CIA	ron	hagrid	number	
accumulate	he	they	that	PCB	
rent	he	host	group	I	they	that	
acknowledge	editorial	everybody	we	biosphere	he	she	
imply	lable	advent	it	leverage	
communicate	Juan	I	they	
mess	this	they	who	you	
defend	James	who	
greet	member	Bray	people	
fold	bag	arm	
screw	they	
dine	you	I	who	
deploy	Johnson	States	who	it	
sweep	Americans	mood	communism	we	child	
evaluate	we	Google	client	
shower	I	
differ	design	they	audience	prerequisite	scholar	each	it	
drill	we	
construct	wealthy	man	company	
bend	malfoy	he	
assault	he	
breed	mosquito	
boost	consumer	
resolve	house	
abandon	IP	they	people	who	Higuchi	he	Stephen	
proclaim	Bush	who	assembly	nominee	
convince	that	they	he	we	book	who	
insist	official	Barno	we	he	who	man	Neil	weasley	you	they	
deserve	country	FBI	they	he	atmosphere	she	provocation	you	it	view	
skip	band	you	deer	she	
compound	which	suspicion	he	it	
profit	Enron	
hedge	they	
rip	bear	that	I	they	he	
twist	Murillo	he	
concentrate	you	I	Grammar	andrei	it	
signal	loss	story	man	
flirt	we	he	
crack	plastic	BA	
dominate	element	you	he	
swing	pendulum	head	counterman	Nellie	swell	bight	door	handbag	
divide	Channel	that	Shakespeare	which	
solve	which	this	we	purpose	nasser	
pretend	one	which	he	we	
permit	that	Bush	
consist	most	group	base	intervention	sample	Island	category	chart	which	border	work	branch	
monitor	you	we	customer	
assess	we	purpose	
pop	they	I	
convert	you	I	which	
investigate	committee	States	Force	project	study	review	police	
surrender	I	force	he	
nest	swallow	
predict	model	commentator	you	guru	forecaster	one	I	economist	psychologist	he	
expose	it	depth	
modify	I	government	
transition	NASA	
stir	something	that	breath	
attribute	you	Balzac	
download	you	
breathe	it	child	
engineer	who	
excuse	archbishop	
educate	we	
venture	Baghdadis	you	temperature	I	
initiate	someone	I	NASA	
frequent	who	I	he	
adapt	evolution	she	he	annex	commission	
wrap	I	
anticipate	PG&E	we	all	I	he	fan	you	
invest	it	I	foundation	they	bank	he	investor	
arise	need	question	quarrel	he	that	fault	
cast	all	
knock	I	he	opportunity	who	Ginny	they	something	
fry	mother	
detailed	document	
shine	eye	water	Chapman	moon	moonlight	light	Mweta	
impose	form	agreement	that	
pursue	they	Cloughs	South	Ulrich	Springer	
blame	Kerry	everybody	I	you	he	who	
eliminate	you	we	they	that	
invoice	they	
stress	he	cat	
burst	he	babble	elf	boy	shed	petunia	vernon	it	car	
sing	he	we	bird	that	boy	Evelyn	I	Odara	
mount	you	hundred	fee	expressionist	
bake	they	
calm	Cola	
appeal	that	bar	prosecutor	
glance	he	Quinn	she	
accuse	observer	Islamabad	complaint	opinion	Greene	minister	
deny	Commission	India	he	we	Church	which	
succeed	US	it	defense	Zawahiri	they	technique	I	settler	who	all	
owe	Israel	who	I	success	Balzac	surface	which	soliloquies	
favour	Al	Japan	quarter	we	which	
threaten	case	letter	he	China	Abramoff	it	guerrilla	Rita	storm	voice	strike	body	
drag	enforcement	he	you	
milk	they	
acquire	they	it	child	
prompt	demand	report	
adjust	animal	this	cat	she	
sail	Force	we	I	he	hat	john	they	Christopher	
register	you	I	
cry	one	I	America	she	he	Clough	bird	
calculate	colleague	query	you	
transform	Inc	you	India	
blind	vision	
generate	issue	it	we	military	action	that	they	who	CM	
protest	they	Japan	Palestinians	terrorist	Rebecca	
engage	Ahmed	we	element	you	
loose	Qanooni	one	horse	it	
urge	Tajiks	he	agency	Blanco	I	we	
negotiate	you	we	who	government	
amend	I	amendment	
lock	democrat	they	I	that	
suck	kid	he	service	product	I	i	teaching	suckup	the	man	thing	
wander	you	I	it	Quinn	he	man	Stillman	they	she	
switch	tundra	I	we	you	
burn	snake	they	sun	chalet	
lean	Communists	her	she	Dobby	Auster	woman	ron	Quinn	he	
ring	I	she	it	Roly	telephone	Quinn	that	ivory	bell	
slip	service	share	that	I	WTO	impression	he	it	hong-kong	harry	creature	girl	they	
resume	Israel	
glow	substance	it	curtain	
brown	they	
capture	intelligence	MMA	you	GDP	alliance	republican	
afford	Congress	people	tm	developer	i	I	that	you	which	this	country	
retire	he	who	veteran	Dr	Shakespeare	
pledge	who	participant	Bush	Group	Abbas	state	
warn	diplomat	tribe	he	owner	I	confirmation	expert	
bet	I	you	i	
grab	I	we	they	program	
found	they	he	who	evaluator	Augustus	
paint	who	BRIDGET	that	
crash	4G	process	that	server	helicopter	it	
regret	you	she	we	I	union	
struggle	company	he	which	
freeze	vodka	it	you	temperature	
strengthen	use	he	
tend	coverage	it	those	media	male	french	girl	all	this	they	we	people	cap	state	system	sentence	culture	magma	
root	Iraqis	construct	
narrow	FBI	I	
highlight	I	research	consultation	report	move	
volunteer	Jen	Google	none	who	I	man	
dust	rancher	
rush	he	ARVN	i	it	
bridge	deal	
suit	combination	
assign	we	you	
rescue	fisherman	
earn	Bush	he	it	Kenneth	who	you	Nathan	Cleveland	they	she	insight	customer	
import	group	States	you	
ruin	it	this	they	guy	few	
label	humanist	
crop	shop	
rocket	worry	
employ	J.	one	they	it	
pose	he	Iraq	presence	spike	that	
incorporate	that	which	it	Jim	we	
steal	looter	she	Natzi	I	you	it	someone	they	
favor	state	who	he	
vacation	I	
guide	she	use	
remark	Peder	Stan	she	he	
edit	you	
stream	body	people	
operate	cell	who	enemy	circle	part	we	sight	he	database	which	
defeat	who	this	Ruy	they	independent	he	
bother	none	who	I	it	i	one	he	
contribute	history	ESAI	demand	ban	that	study	all	they	programme	measure	standard	synergy	innovation	employment	Starlin	
reveal	interrogation	disaster	Anthony	time	report	study	result	which	Father	question	adoption	excavation	that	correspondence	character	page	analysis	survey	contingent	
shut	I	water	BP	Marathon	someone	Dobby	he	brain	cabin	they	you	
float	that	chemical	greatness	voice	masterpiece	
climb	cat	Dow	she	he	you	I	passenger	fred	harry	they	think	
branch	one	they	
award	company	
remind	it	we	that	he	this	think	john	I	harry	crash	
commit	someone	it	interviewer	we	which	marketer	you	who	king	Ramesses	
transfer	he	everything	that	Balzac	
assist	scientist	EnronOnline	Jim	who	he	strategy	that	seminar	
ignore	you	he	ant	friend	we	companion	
fuel	event	commitment	desire	
combine	learning	art	study	nexus	Shakespeare	%	
double	price	share	
explore	he	participant	research	theorist	James	
teach	that	teacher	Mrs.	he	who	excursion	I	
mass	army	
reply	Hiller	you	Sir	George	he	she	
settle	foreigner	thing	it	he	I	Stillman	harry	who	
cap	that	
obtain	Qaeda	person	we	Iran	he	she	you	john	state	
lift	that	you	Columbia	Yuri	William	he	
proceed	we	you	he	Moxon	who	work	research	
match	Sitara	value	we	tag	that	Mets	centrality	
rank	Israel	Quantcast	almanac	region	
route	he	
tire	I	
inspire	neologism	What	student	he	consequence	romance	Shakespeare	
photograph	I	
examine	assessment	conference	it	report	he	we	commission	evaluator	
collapse	army	enron	Dow	Norton	Union	you	much	he	cod	
welcome	official	crew	we	he	group	proposal	conservationist	
speed	it	car	worker	that	
enable	standard	connection	registration	this	development	content	problem	you	which	that	exclusivity	rebalancing	provision	
smoke	who	call	you	we	people	he	east	I	
oppose	it	we	Americans	who	AMERICANS	Sharon	US	they	Bundesbank	
promote	wolf	country	enforcement	it	
cycle	he	
wheel	three	Quinn	
fee	that	
delete	I	we	geeksquad	he	you	
inform	you	we	city	Questar	I	she	time	one	
recognize	he	program	we	marriage	I	you	Access	customer	they	country	scientist	
battle	team	Łódź	
distribute	it	we	you	
stare	everyone	hasidim	he	Harry	eye	harry	hedge	you	they	mask	
skin	pole	
wave	he	
repeat	you	media	Lord	I	Higuchi	he	Bray	
graduate	she	he	i	I	you	
hurt	they	he	male	it	ball	
supply	which	she	who	
screen	that	
shake	President	Thai	counterman	he	Dobby	detonation	she	that	I	hand	
advance	price	man	vernon	army	
master	Shakespeare	
bomb	helicopter	that	
hate	Shiites	nature	they	I	i	who	he	you	Google	she	
collect	FBI	we	cage	father	someone	that	capsule	goal	microscope	he	Corps	Stillman	jew	RHS	
bite	bug	he	that	cat	they	which	business	
expand	economy	edge	opportunity	you	Google	city	NATO	Tulsa	I	volume	he	business	they	
connect	modem	you	which	Trail	user	who	they	that	
desire	heart	you	
revise	we	I	Balzac	Shakespeare	
race	who	boy	he	
sight	Bransfield	
block	Chalabi	they	that	hasidim	
shoot	sniper	militant	you	killer	I	child	spark	he	guard	
count	i	I	that	they	we	
observe	we	Norton	teacher	Patterson	News	Wikinews	Quinn	someone	paper	
survive	you	they	all	place	Google	I	who	house	harry	section	record	version	play	description	
participate	you	who	that	I	it	n	person	foundation	women	
nail	Scots	we	
pack	you	Rita	people	womenfolk	other	
crowd	hundred	
cash	I	
host	who	Plus	they	IEP	he	city	
roll	I	head	this	none	that	family	
command	Bush	Fresleven	malfoy	
prefer	I	you	we	citizen	that	he	Hitchcock	
bill	they	we	
seed	program	
pair	that	
shape	egg	
argue	one	I	people	other	Zawahiri	scientist	organization	they	guy	agent	post	some	we	Carney	he	greenwood	poet	government	you	
spread	anger	that	fungus	fame	he	reputation	latter	
wind	War	path	you	document	he	line	
mail	you	I	he	
dream	you	I	
rock	place	that	
lower	rate	addiction	growth	
tour	you	I	
invite	buddy	I	you	Mweta	member	
plane	Michael	
click	I	light	people	they	
slow	time	plaster	we	Mérida	agreement	
tie	they	he	
weather	suspension	
spring	hair	harry	that	
belong	I	that	message	posting	you	apartment	it	who	Ōtsugomori	ant	andrillae	premise	account	responsibility	person	they	Titus	feat	Andes	
destroy	murder	who	you	he	Germany	guilt	fire	
execute	it	that	Satan	you	
advise	lawyer	attorney	we	they	I	which	
s	something	
announce	authority	commander	sender	secretary	Microsoft	they	Court	we	Russia	he	Nasrallah	it	organisation	government	Administrator	minister	
define	you	government	Nations	that	xml	schema	which	syntax	
affect	it	abuse	that	climate	impact	disaster	movie	most	which	change	you	group	delicacy	result	innovation	amendment	saving	nutrition	
jump	Indians	price	he	they	you	we	page	corridor	dursley	harry	dobby	
hire	chief	I	they	we	him	you	he	Cervantes	
flow	money	gas	that	tributary	I	resource	which	river	
cool	temper	pan	
escape	many	hamster	they	it	rabbit	he	Hamster	Harry	john	that	harry	intellectual	you	
stick	some	i	I	she	chambermaid	we	who	muzzle	
wash	rain	you	this	i	harry	that	
smell	they	apartment	seafood	place	it	she	inside	basil	you	he	
worry	that	I	you	
surround	it	that	happiness	
camp	you	lodging	
adopt	I	America	it	we	Shakespeare	commission	committee	that	Greeks	
advice	you	
damage	transition	
indicate	which	number	pattern	email	they	Kevin	answer	that	group	Kofi	Bruce	one	result	who	name	record	I	point	state	standard	Zola	
encourage	derailing	agreement	judge	they	I	you	report	it	Directive	course	earnings	
emerge	that	India	it	performance	categorization	face	sprout	bias	he	low	China	which	constitution	they	state	
sink	implication	it	who	God	Iraq	missile	ship	Dow	boat	sun	she	skin	gnome	
dance	she	i	you	they	who	
implement	you	they	
declare	ISO	it	group	Mahmoud	I	Anon	he	commission	presidency	they	leader	Minister	Balzac	novelist	Mongolia	rival	
stage	we	
balance	bird	we	
garden	he	
gain	they	I	University	camp	chrome	attempt	user	which	he	
finance	who	
reserve	PaineWebber	we	I	licensor	
equal	amount	body	disadvantage	
average	cost	
stock	I	they	
arrest	suspect	they	army	it	
exchange	people	Korea	we	he	authority	
chart	album	
relate	I	they	surveillance	inquiry	information	it	Mayko	that	many	audience	we	question	two	figure	
prove	influence	it	that	search	you	we	they	Columbia	incident	exploration	Congress	event	system	capitalism	intervention	transfer	crisis	date	both	
hang	career	everyone	I	receptionist	flesh	he	that	who	elf	vernon	instrument	spectacle	
fit	company	I	who	it	fish	smaller	cruise	that	item	we	he	amendment	site	emphasis	
initial	I	lawyer	who	
strike	who	they	performance	think	I	wilderness	he	beam	idea	famine	
waste	I	choice	
lay	difficulty	third	two	they	cockatiel	chameleon	outfit	disease	
maintain	LTTE	Musharraf	proposal	I	they	he	who	camp	city	commission	she	country	tradition	state	
suffer	Afghanistan	he	we	plan	military	who	hamster	I	Palestinians	child	Greece	city	storey	humankind	chicken	that	Balzac	work	it	land	Bouchard	
marry	husband	he	Timothy	Hanska	Shakespeare	Susanna	Judith	who	Cumberland	daughter	
prevent	it	you	money	that	delay	Pentagon	fraud	cat	feeling	
cook	food	guy	that	who	
smile	who	picture	wife	she	Quinn	stalin	he	
star	Blunt	she	
occur	that	crime	collusion	which	error	change	extinction	seizure	most	it	access	violation	this	damage	accident	attack	rain	monsoon	thunderstorm	blind	vote	deed	influence	
protect	speech	that	you	job	principle	thing	
grant	ISI	licensor	Licensor	that	she	ticket	
feature	call	phase	that	interview	website	podiobooks.com	novel	Rodin	landscape	film	
correct	it	we	
assume	that	I	you	they	i	guy	she	people	city	he	we	article	
murder	they	he	
appreciate	I	comment	horse	we	tourist	
sleep	he	you	we	I	Renata	she	her	baby	
judge	I	Quinn	people	
refuse	Commission	Qanooni	Mujahedeen	parent	first	Winter	generator	some	who	soldier	aficionado	snake	he	salesperson	receptionist	she	they	office	leader	Jihad	Alan	israeli	Dando	we	Augustus	Minister	
appropriate	adherent	
respond	she	who	you	I	they	he	camera	child	s/he	Thai	parliament	Europe	
seat	they	
fail	Bush	they	initiative	I	caper	tactic	decision	it	this	that	people	he	which	European	force	concern	effort	business	magazine	who	health	
perform	it	we	ship	Duct	window	someone	you	I	man	they	army	
express	Aafia	they	that	we	US	cleric	director	which	one	I	commission	she	people	
cross	you	I	he	Stillman	that	which	harry	variety	force	
ride	who	that	it	he	
park	you	I	
hide	I	Mohammed	you	
evidence	plan	
compare	Mike	you	nothing	I	dress	Rick	standing	we	plaque	
update	Susan	we	
limit	budget	resource	objective	potential	
blow	war	preacher	son	she	I	it	department	wind	hailstorm	they	enron	hector	he	taint	coolness	material	
deliver	administration	they	I	food	it	HDS	you	John	dollar	
separate	sect	i	you	they	xml	voice	that	
demand	all	movement	he	they	cleric	Kofi	you	Mahmoud	user	librarian	house	it	Russia	audience	
range	contribution	
surprise	letter	they	ingredient	which	I	Bray	we	governor	
challenge	anyone	which	athlete	he	that	they	
chair	who	
object	who	one	I	
taste	coffee	food	enchiladas	it	I	all	slice	you	basil	
hit	that	it	price	antichrist	I	you	Kelly	Michael	they	we	horror	shell	Kingsman	impact	Floridians	
confirm	much	spokesman	he	Ashcroft	you	they	who	call	Matt	result	
replace	this	I	Excel	they	that	sanitisers	back	you	wave	
warm	planet	it	he	
influence	cubism	it	he	writing	Balzac	work	Shakespeare	medicine	
spot	fred	I	
promise	government	President	they	which	China	I	lisa	corporation	Roly	we	guarantee	
throw	Judge	elephant	Dr.	Mr.	Iran	they	I	i	it	dog	Hamas	you	someone	referee	harry	she	follower	
push	diplomat	member	I	they	which	you	news	it	tendril	Quinn	administration	neck	number	
trust	they	bird	we	I	you	advice	family	
guess	I	i	who	he	you	Quinn	
imagine	I	you	we	they	he	Quinn	Marx	which	
quote	report	I	Berlin	company	Times	you	he	Samuel	
author	he	
budget	Bush	
dry	it	soil	which	
pull	organization	rebel	I	she	leg	he	it	you	people	daughter	ad	they	bar	train	Dando	
heat	they	blanket	air	
launch	guerrilla	force	China	that	they	he	astronaut	crew	military	Microsoft	Union	I	which	civilians	wife	we	organisation	
manage	team	US	he	I	she	who	we	Stillman	boy	you	harry	hagrid	vernon	
publish	IAEA	STAR	Nina	he	we	it	commission	John	Shakespeare	
debate	student	we	he	they	
reflect	system	mill	which	that	draft	total	anything	name	document	estimate	everything	they	situation	metric	it	La	this	
catch	I	you	ranger	building	they	screen	she	player	Fred	each	he	light	we	man	harry	
conference	I	
achieve	we	musician	site	goal	wikiHow	you	Wales	country	India	it	
practice	you	ship	i	I	
dress	i	man	option	
press	they	I	you	weight	air	European	
target	Zawahiri	we	
mark	response	it	flight	you	century	week	that	play	finale	
impact	training	temperature	
trouble	it	placidity	story	
draw	assassination	this	we	she	draco	it	Balzac	I	mrs	partner	US	that	he	which	psychoanalyst	expert	
approach	Ms.	lady	date	you	they	death	which	car	I	man	time	
figure	he	I	we	you	vet	they	
arrive	murder	Elliott	bus	spring	bird	that	they	we	I	Dan	who	guy	you	table	million	settler	traveller	Indira	he	Bray	she	other	string	group	indian	
handle	I	who	you	Bush	i	snake	they	that	somebody	
estimate	report	they	you	I	Markus	he	particle	Church	study	
represent	that	hand	step	it	piece	we	this	storyworld	fan	research	area	which	bad	he	report	character	you	I	forecast	ingenuity	country	tragedy	figure	who	god	Jasmine	president	leader	
board	you	I	who	
reduce	that	you	bill	result	which	it	friction	official	space	peroxide	growth	ecosystem	enrollment	health	
forget	I	you	they	i	he	who	people	we	she	ron	script	
e-mail	I	
model	I	
avoid	US	you	wife	it	ant	we	I	one	
feed	they	friend	what	I	she	we	you	i	
laugh	he	mare	she	I	media	customer	they	room	Neil	Bray	Odara	fred	Auster	
finish	we	Liz	I	they	jill	cycle	you	he	delivery	Brooks	who	
select	Jerry	you	we	Force	he	
round	he	
content	same	we	
focus	Bush	Jihad	panel	committee	rom	that	they	study	polytheism	work	group	section	
voice	official	
red	I	
benefit	which	who	NASA	that	dog	reputation	debate	rest	majority	they	
trip	Patricia	bear	teacher	luggage	
interested	what	story	
improve	U.S.	finances	theatre	site	that	training	cleanup	it	they	fund	you	programme	
propose	Essie	I	you	Ruy	company	Gorbachev	Bush	resort	commission	we	it	administration	
performance	that	
respect	we	that	I	requirement	
rise	Nimr	water	level	sun	price	contract	she	they	downtown	he	bosom	export	laughter	we	eyelid	one	stink	Bray	R&D	Europe	standard	share	everyone	
sell	he	you	she	Vince	place	line	they	I	building	that	who	Lepoitevin	investor	
text	I	you	
drop	number	bus	he	I	jaw	they	camera	this	ozone	cab	ensign	borgin	rate	we	population	
search	I	you	user	volunteer	people	seeker	Access	it	he	
fire	I	troops	you	KPA	Korea	
attend	you	Shankman	Stan	I	Bush	we	three	Hadid	he	visitor	reporter	she	they	Elliott	Tina	
involve	which	crime	game	that	form	method	majority	much	most	oath	theme	
join	president	he	Israel	soldier	you	Bilbray	I	Anthony	KENNEDY	SOUTER	THOMAS	SCALIA	ALITO	those	who	institute	editor	Bray	Odara	prelate	laboratory	
purchase	I	we	hr	China	you	
prepare	person	we	Bush	they	he	it	
condition	she	
fax	you	we	he	I	
wish	they	you	I	we	i	who	one	Mohamed	he	Harry	it	mum	
reference	you	they	
contain	which	computer	email	form	that	it	square	eHow	basil	chart	level	section	group	basic	notebook	report	document	Directive	comedy	tragedy	ocean	district	history	
remove	you	Winter	Joe	dryer	he	pope	
foot	Corp	
kid	you	i	I	
lack	John	Bush	we	they	it	room	I	you	rabin	coordination	diversity	infrastructure	Indian	phone	
fill	2005	I	they	Bowtie	you	that	scene	balloon	chute	thigh	he	thought	noise	head	who	
fly	George	who	that	they	I	i	astronaut'	you	we	Chatham	electron	hasidim	he	owl	it	voice	African	she	hair	spark	flock	
arm	US	all	
fight	you	they	we	he	male	cat	I	who	reason	people	american	harry	
produce	plan	that	he	mine	they	bulb	it	puppet	goal	oil	age	joke	query	proposal	approach	mister	mycelium	technology	farm	decline	Shakespeare	victorian	who	Rafferty	one	
father	he	
describe	cleric	Chalabi	he	I	who	you	paper	puppet	professor	Bos	Church	magazine	category	Cervantes	Thomas	it	ansi-89	that	which	html	economist	critic	Folio	Zay	musician	
contract	Pentagon	line	
trade	country	DB	they	
pick	activity	we	you	i	I	CIA	he	someone	they	mother	Carroll	editor	development	way	Quinn	she	
complete	I	other	drawstring	who	CEN	Balzac	wit	
research	I	
wonder	you	I	i	people	they	he	
joke	youngster	he	I	
draft	we	you	I	
notice	I	world	you	we	i	fisherman	agent	he	harry	
release	Gore	Kerry	authority	people	agency	it	they	he	group	NiMo	Mobil	we	Balzac	technique	foundation	band	Kesha	
cut	they	who	Bush	it	she	we	that	you	man	youth	project	
detail	that	
rest	authority	you	she	that	Stillman	haze	river	phantom	fate	
plant	which	you	
ensure	dictatorship	Delhi	people	that	we	this	they	investment	recourse	referee	it	you	commission	state	rebalancing	strength	
wear	he	recruit	she	you	force	i	I	woman	strap	attendee	man	they	people	time	Quinn	it	lockhart	all	
suggest	who	I	estimate	Chairman	they	he	Kathy	ENA	colleague	website	she	name	organization	i	researcher	it	which	one	graphic	that	mister	Biographer	scholar	biographer	evidence	you	analyst	Vega	voting	David	
establish	letter	we	pipefitter	which	agency	she	that	L'Enfant	you	96/96/EC	commission	I	it	Slavs	Sparta	
shop	I	you	
cover	it	which	stream	you	viewpoint	SOLAS	sonic	class	heaven	clothing	mat	amount	ron	foot	organisation	part	growth	
risk	who	snake	Google	it	I	hold	that	
mention	he	newspaper	I	email	you	James	Bush	that	i	it	report	speaker	no	will	
accept	Tigers	army	family	he	we	people	you	who	they	that	she	MSM	university	Quinn	I	other	Bray	Council	commission	citizen	official	Germany	scholar	king	
share	both	I	who	we	that	libertarian	Stormtroopers	they	Lake	page	control	you	
interview	they	we	Wikinews	
ship	they	
claim	who	Wilson	official	nobody	newspaper	bozo	they	which	people	that	message	woman	Paris	Church	staff	he	enthusiast	factotum	scholar	biography	
effect	article	
die	eyewitness	he	Balance	who	people	they	animal	cat	RAPHAEL	St.	DURER	Sir	EL	LAURA	John	Ruy	Ivan	Sutcliffe	Brian	mouse	that	person	it	Frank	brother	she	ant	part	you	wife	adolescent	man	mother	parent	witch	which	tension	progeny	Balzac	Shakespeare	Millican	retiree	
drink	he	they	you	pioneer	
lie	politician	who	difficulty	self	much	connection	happiness	answer	Wolfowitz	i	you	power	distinctiveness	riverboatmen	she	we	island	chicken	that	agent	it	airway	center	ship	meaning	importance	he	jumble	assortment	wand	problem	part	
subject	leaders	
rather	I	
carry	they	who	fellow	he	shuttle	that	making	curse	store	ship	contractor	restaurant	you	people	spacecraft	way	vowel	one	she	leg	influence	debt	we	detail	
interest	that	
record	you	reader	he	chronicler	Sir	vote	Leonard	certificate	Rafferty	
save	that	Kerry	we	who	Bush	hundr	they	service	Navy	companion	you	all	what	dobby	user	
kill	force	guerrilla	they	Qaeda	piece	Assad	Saddam	commission	it	that	fighting	he	Israel	I	man	disease	who	she	
reach	you	they	which	Aafia	party	message	we	name	Sunburn	he	exhibit	level	stalk	elevator	it	negotiation	Quinn	life	FDI	chancellor	that	consequence	some	artist	
contact	you	I	they	we	he	John	
land	they	starter	you	shell	we	animal	
agree	I	i	extremist	judge	IBM	Arthur	they	he	company	Jeff	we	you	President	everyone	report	Iran	Communists	Syria	Hall	three	agreement	Gorbachev	George	Alexander	middle	commissioner	george	many	tatu	group	parliament	house	state	participant	biographer	most	playwright	who	
pass	tanker	route	year	you	I	he	train	cat	Netherlands	it	rat	who	car	grandparent	grandfather	grandmother	people	time	that	hour	we	jeremiah	ship	they	load	Court	Rowe	Carolina	
spend	George	who	Zawahiri	I	you	that	Parmesan	Iran	Pentagon	US	firm	Bush	States	people	they	family	Norton	baby	Gloria	we	many	he	Paul	
break	which	we	hell	hostility	she	they	that	membrane	c	car	peddle	window	clash	coalition	i	skin	Tulsa	part	you	this	he	Mweta	convict	argument	rage	it	fight	War	
learn	he	board	agency	Dr.	Rumsfeld	you	mine	I	student	she	we	Carroll	people	reader	they	who	one	theory	type	Bray	harry	Marcel	
choose	US	we	who	Iran	I	you	they	husband	people	he	ant	NASA	hasidim	Don	hero	citizen	physicist	
link	we	it	A1	he	trend	
require	that	version	you	it	state	they	rodent	reptile	emergency	camera	Org	handle	airline	some	other	place	objective	student	interpretation	this	Europe	we	development	setting	policymakers	disbursement	implementation	rule	body	
drive	you	weather	we	restriction	I	wife	they	i	bus	nacho	who	source	Tulsan	freeloader	notion	he	fred	it	
concern	it	that	report	first	amendment	adaptation	set	challenge	novel	Balzac	
clear	father	population	he	who	
develop	Tigers	which	they	someone	I	that	company	Spaniard	it	Iran	chick	egg	NASA	country	you	problem	experience	she	who	we	human	china	society	he	friction	Rona	student	
fund	money	it	Iran	revenue	assistance	
measure	we	ounce	pint	that	
type	you	we	
vote	Taliban	member	committee	you	Vestry	he	who	I	we	anyone	guy	reader	parliament	it	group	people	
near	you	career	
present	link	intelligence	I	you	we	Sergey	it	group	poster	he	commission	Reginald	event	which	release	China	league	
appear	who	column	which	Rev.	phrase	that	hijacker	entity	situation	trickle	behavior	Judge	news	you	piece	it	decline	name	video	logic	respondent	label	field	head	man	think	cliff	change	this	eye	face	dursley	element	funnel	setting	property	redeemer	one	cat-flap	hand	weasley	credit	update	she	he	friend	many	draft	Klein	Wintour	Kong	Jutting	story	ground	
decide	general	Emminence	many	MKM	you	I	we	Larry	Iran	China	they	Bush	Higuchi	he	wife	that	american	minister	Quinn	council	one	Balzac	Mexico	Pilate	filmmaker	mayor	Enrique	
serve	that	John	Bush	he	Mr.	publication	this	which	government	mailing	President	who	they	poster	chef	Sanctuary	sector	you	we	wikiHow	image	I	fact	armenian	criminal	adam	election	it	abundance	altitude	
watch	we	I	you	they	who	i	President	crowd	science	he	this	what	harry	wizard	Quinn	
build	CIA	focus	we	NASA	plan	you	andrea	i	I	they	corporation	bridge	tag	model	which	who	he	jordanian	pressure	partnership	South	architecture	
expect	I	you	US	we	he	campaign	what	i	some	agency	one	people	city	man	president	Quinn	daughter	they	investor	government	
document	which	researcher	
filter	which	kidney	you	user	
side	Shiites	
matter	what	this	it	I	that	
bear	County	RAPHAEL	that	LEONARDO	Gianutto	he	she	one	plot	pad	it	I	EUP	economy	Louis	sister	
lose	we	I	family	who	you	cat	that	he	trotter	they	Sharon	US	it	Cyclone	cyclone	Earth	veteran	specie	other	Mets	hostess	sister	she	harry	face	Europe	Balzac	human	empire	old	
forward	I	you	he	she	we	Mary	Jason	who	someone	
account	one	which	he	version	both	they	you	product	IP	sector	
attack	insurgent	who	you	they	US	George	rooster	she	that	he	which	we	hacker	mum	it	victim	contaminant	
discuss	Mr.	conference	we	you	Laurel	I	John	Valerie	Val	they	that	Sarvis	he	guest	people	
request	part	we	John	EOL	Questar	Enron	President	you	they	I	number	
regard	writer	Iraqis	you	Japan	they	
mind	you	we	he	
rate	mate	I	Nations	critic	poet	
access	you	people	user	
charge	prosecution	India	we	generator	producer	that	line	you	Nick	they	vendor	A&E	he	charger	critic	
cause	killing	accident	visit	that	they	Zawahiri	this	which	girlfriend	increase	change	bedding	emergency	Nile	storm	ozone	pollution	fear	hypnosis	effect	water	he	replay	nature	loss	inexperience	warming	exchange	
remain	immigrant	India	name	undercurrent	officer	US	woman	state	Iraq	extradition	it	I	issue	detail	partner	they	program	many	Lopez	that	aspect	Sunnis	you	road	leader	struggle	role	Hamas	k	Tagbanua	she	service	estimate	Jespersen	distance	he	problem	what	man	thing	date	individual	people	policymakers	gap	rate	piece	option	Comédie	play	attribution	America	who	shopper	Danevirke	dominance	
increase	disability	pressure	Senate	heat	temperature	absorption	emission	population	seat	website	Firefox	school	undernourishment	ozone	warming	chance	demand	error	you	number	which	introduction	inflow	regime	FDI	EU	malnutrition	we	usage	amount	destruction	
enjoy	I	he	Mr.	you	she	nation	family	dog	we	they	BRETT	city	Wikipedia	many	Łódź	Mérida	man	hasidim	syria	Neil	harry	region	child	that	
clean	it	I	we	worker	he	harry	
allow	he	that	CIA	which	order	they	winter	kid	page	Zarqawi	option	application	business	circumstance	nature	depot	addition	field	we	it	css	debate	Facebook	who	you	I	chancellor	setting	charter	GCA	pattern	Curie	disc	minister	
post	we	you	that	I	they	he	someone	which	captain	Quinn	two	
remember	I	who	she	Baba	you	Lennon	just	animal	Kevin	he	i	that	we	dursley	Quinn	
value	we	EPA	that	who	
rule	judge	who	Huskers	Sooners	Hamas	Court	court	spokesman	
stop	Bush	war	who	this	you	I	behavior	snake	we	anyone	that	she	t2i	rain	Higuchi	they	enemy	broadcast	chicken	it	child	he	Harry	yoyo	music	station	
attach	I	that	spreadsheet	you	we	
sign	Briggs	someone	Laura	representative	she	Janet	Gas	we	customer	firm	rector	people	all	I	who	gilderoy	you	Shakespeare	he	
step	that	Louis	I	Edison	you	they	Fiona	President	politician	Oakland	we	malfoy	harry	government	
care	who	I	one	he	i	mother	they	school	she	staff	company	dursley	you	that	
cost	recoil	which	this	they	it	service	life	that	visa	tariff	diesel	
phone	Jann	they	you	
consider	who	anyone	we	I	you	latter	bear	they	some	he	U.S	kind	strategy	money	society	explosion	critic	group	regulator	Balzac	which	republic	Yuan	
stand	Bush	text	they	nothing	we	this	it	he	Syria	Iran	that	person	fps	boy	traveler	she	who	woman	I	Theater	student	Europe	Quinn	man	which	john	Adamson	Englishman	Bray	Neil	vernon	all	witch	hermione	rest	flower	Labrador	harry	door	rate	Ukraine	edge	
review	I	conference	controller	you	we	he	agency	Tanya	it	anyone	
happen	what	it	they	all	this	September	holocaust	same	you	something	that	nothing	miracle	thing	revolution	anything	aftershock	type	husband	who	we	z	which	What	stampede	everything	leg	today	I	process	event	
control	ICDC	that	system	you	what	which	
check	you	I	they	Ray	he	i	gamestops	we	mechanic	custom	Access	
grow	FLDS	most	Jaime	that	movement	we	it	trickle	thou	he	alga	i	you	I	Hathaway	associate	cell	earnings	they	population	fungus	event	which	plant	thing	Cactus	cactus	cutting	distance	institution	sense	mood	this	ministry	pine	room	mycelium	report	economy	asset	baby	GDP	who	mastery	significance	tumour	list	company	change	Brisbane	she	
sit	island	staff	you	we	I	that	friend	they	pizza	who	someone	he	mixture	mother	doctor	Professor	man	cup	Quinn	woman	Dorothy	Harry	Marlow	passenger	she	vernon	harry	one	bundle	girl	plan	
level	you	he	
reason	city	he	
continue	Baathists	fighting	increase	it	element	ENE	he	who	we	review	behaviour	you	debate	program	mystery	UPI	report	brief	trend	she	baker	food	back	problem	I	violence	they	Enron	Sam	chrome	broadcast	festival	comeback	Cleveland	experiment	oil	Quinn	meaning	corruption	ship	collection	many	country	finance	license	work	tank	process	number	programme	dilemma	standard	generation	that	Splendeurs	Shakespeare	investigation	military	
game	I	
email	you	I	mom	i	one	someone	
buy	I	he	money	i	you	most	we	they	approach	who	she	mum	woman	
commission	Shona	Marquis	he	tower	
lead	which	that	he	support	search	reappropriation	it	arrest	I	action	shortage	piping	they	deficiency	reality	size	specie	attention	wire	Auster	shahar	seaman	this	band	spellwork	one	margarine	codependency	regulation	innovation	each	Eliot	demand	who	change	enough	contact	existence	success	collapse	
close	Pakistan	market	it	you	many	they	office	party	poll	door	mite	company	he	shop-cum-post-office	finger	eye	
project	you	Worldwatch	jetty	
light	I	Festival	he	they	media	
thank	everyone	family	I	they	he	
force	subpoena	circumstance	China	they	problem	it	victory	
free	israel	States	plan	
visit	leader	you	they	we	Thane	he	man	I	refugee	Ruy	friend	Liberty	both	President	i	that	people	who	Balzac	
offer	Project	Sunnis	Assembly	we	you	I	group	they	he	cruise	ship	Tours	chef	that	she	BNA	VCU	drip	it	hospitality	place	intervention	agency	Lee	distillery	which	Airlines	Airways	airport	hotel	company	thousand	opportunity	Weasley	who	licensor	mechanics	EU	agriculture	advance	Passez	play	park	
speak	it	victim	Mr.	I	Laird	demon	he	they	you	i	she	who	we	latter	that	mother	me	Wikinews	one	carrier	man	Quinn	child	woman	house	Odara	Evelyn	review	escola	member	mister	Balzac	
study	Jafar	who	phenology	I	she	you	he	work	Balzac	
head	convoy	boat	Hikmetyar	I	who	it	they	
eat	cannibal	he	lion	fish	parent	dempsey	I	it	they	cat	bird	snake	Beardies	people	girlfriend	we	anyone	who	she	four	you	dog	ant	family	Quinn	Stillman	dolphin	that	
base	fool	Center	that	green	growth	comedy	
bring	overthrow	that	MKM	Stan	Becky	insult	it	biologist	Uranus	attack	he	i	you	I	we	server	who	decision	move	project	sport	Genesis	stardust	revolution	Mets	which	this	they	accountant	glow	fred	hindenburg	Jason	company	stance	fulfillment	deal	war	Antonio	
walk	he	woman	we	man	Bush	I	owner	you	she	they	Montalvo	that	Percy	Peter	Quinn	boy	one	tapper	Kenseth	
plan	they	Bin	I	you	fitter	we	official	Bush	who	family	wife	she	Chase	NASA	he	project	Harry	municipality	
face	Israel	Musharraf	army	leader	he	which	trip	force	US	you	butt	Steven	apartment	that	we	developer	legislator	Cloud9	side	imagination	village	I	official	farmer	woman	world	she	department	
read	I	anyone	you	they	which	system	change	letter	eater	i	we	he	who	it	u	Amount	that	Auster	Sancho	Access	proof	watch	someone	ron	side	man	she	many	other	post	guideline	news	
meet	I	you	Yazid	reporter	they	we	Doug	Petrarch	dog	who	that	i	humanity	Isabel	she	husband	broadcaster	he	Harry	eye	kermit	arrangement	street	leader	Balzac	Kipling	Winstone	pope	student	
return	most	spotlight	they	we	you	condition	I	she	team	NASA	flier	wolf	cuckoo	some	who	horse	all	i	he	French	mentor	court	garrison	it	function	hasid	child	academy	rest	Trix	anybody	Geyer	Georges	
hope	they	I	we	Tom	committee	Control	i	Bush	he	vernon	Democrats	Mexico	
result	that	which	issue	problem	this	study	request	what	impact	pattern	it	flexibility	campaign	Adverts	conversion	disregard	expertise	fight	urbanization	rate	blockage	
receive	Bush	they	theory	story	Mrs.	ringleader	who	we	you	counterparty	I	he	user	worker	NASA	winner	other	campaign	Library	member	American	answer	Ireland	pup	city	Gary	elephant	Nida	creation	cocktail	band	Mohamed	Kwong	that	institution	which	company	commissioner	commission	49	question	Balzac	Ms	executive	trooper	generation	situation	Uber	
open	Beijing	policeman	you	I	door	they	salon	Papeluna	someone	Google	it	contest	that	profit	we	canopy	one	chute	he	hasid	Ukraine	La	globe	which	couple	people	Loving	treaty	
pay	Washington	who	Spain	we	I	ENA	counterparty	he	it	none	Oglethorpe	they	west	China	you	polluter	guy	nobody	which	i	child	company	someone	Ecogas	rest	server	Palestinians	user	this	wolfson	that	harry	firm	people	customer	
house	that	we	Lee	
case	man	
hear	you	jury	Ismat	I	we	anyone	James	many	i	human	they	that	neighbor	people	who	father	Amneh	he	Dobby	Quinn	harry	
view	they	country	you	Thai	user	committee	parliament	
water	all	eye	you	
begin	trial	some	he	sect	Michele	Russia	Saudis	I	we	hearing	they	dancer	people	many	market	you	Beatles	Devil	Renaissance	snake	number	horse	which	fundamentalist	life	camera	project	both	Nida	story	what	Zealand	broadcast	stampede	obsession	Cleveland	industry	infrastructure	that	letter	station	woman	Quinn	thought	Auster	current	light	ebb	work	summer	negotiation	Kenyatta	everyone	one	eye	it	community	Federal	scientist	Balzac	correspondence	career	period	strand	Shakespeare	critic	doubt	probe	climatologist	settlement	wind	particle	dynasty	fighting	Stalin	Blunt	Greece	text	state	
turn	Pakistanis	they	Musharraf	one	tide	I	it	we	what	producer	he	you	who	m	pic	morning	egg	call	bakery	matter	operation	image	sunlight	toy	this	both	she	Quinn	municipality	something	all	draco	man	people	fortune	value	prediction	Balzac	which	Shakespeare	revolt	
experience	Arctic	who	you	consumer	dear	I	country	Athens	municipality	town	they	core	city	sme	we	
add	he	time	she	official	you	I	we	which	amendment	that	they	other	all	comment	i	Griffin	assortment	skittle	Higuchi	who	it	KCNA	Cleveland	statement	this	Quinn	century	administrator	ron	Shakespeare	series	challenge	Dr	Ms	
deal	I	Bush	she	you	anyone	it	government	that	one	he	which	we	amendment	people	
file	he	generator	they	Enron	A&K	breyer	KENNEDY	SCALIA	THOMAS	ALITO	Center	
form	many	wound	one	mold	that	we	agriculture	you	set	germ	more	this	queue	mycelium	finding	provision	annex	debris	they	
book	you	I	we	i	
run	he	Al	that	she	they	I	you	we	mother	bear	supplies	benefit	grant	cost	argument	metro	taste	owner	who	store	gear	engine	it	car	i	well	Eurostar	school	festival	exhibit	arterials	avenue	street	Trail	snitch	Championship	devil	child	current	edge	dog	Bray	sweat	harry	database	server	programme	Argentina	China	someone	which	government	
love	I	who	we	co-worker	judge	family	President	he	she	i	you	everyone	they	rodent	bird	child	wife	people	daughter	part	american	investor	
line	you	
play	moderate	we	you	Enron	that	some	he	they	who	logic	I	parent	manger	LSU	friend	eczema	she	elevator	player	lead	Olivia	one	fund	IP	issue	farmer	programme	training	supplementation	will	Burbage	actor	investor	cup	which	
hand	minister	military	she	you	george	he	Mweta	petunia	
mean	Norwegians	I	that	government	kg	we	dale	which	this	you	it	Feb	Commander	willow	path	Lennon	horse	word	feather	i	service	Salmagundi	he	gift	mad	@card@	she	reader	flag	Vogelaviatiolap	domain	monk	they	Auster	responsibility	quality	independence	tag	Ras	Work	fact	innovation	Balzac	Johannes	guideline	
price	he	Outback	
order	I	you	President	he	Robert	we	they	Gov	one	
become	they	thing	LTTE	Terrell	fallibility	army	it	Phuket	number	area	delight	Blount	official	Michele	Mr.	incitement	process	that	what	family	spine	mind	secretion	muscle	we	Congress	President	States	you	six	5	Ocean	husband	business	idea	road	money	he	book	occupation	situation	ground	Iron	I	Korea	tourism	Hamas	who	librarian	Norton	history	unrest	system	Pierre	she	relationship	Nida	Anyone	term	hashtag	goer	residence	exurb	plant	chicken	other	grain	mouse	dispute	place	motion	Stillman	man	wall	paint	gloom	serenity	pace	day	approach	solution	problem	amin	pole	task	accident	parliament	%	state	sector	one	obesity	many	which	Balzac	name	republic	Donald	criticism	Karel	this	country	Sea	contract	Jasmine	Joan	power	participation	
seem	he	Colombo	list	it	crime	I	George	that	many	Hatfill	entity	problem	one	absence	expansion	reputation	people	they	pressure	lithograph	which	danger	she	cat	fusion	caucasian	article	everybody	horse	food	employee	everything	who	security	review	will	weekend	Lori	all	decor	this	Santa	trader	something	NASA	step	we	you	condemnation	foot	contact	mouse	what	voice	nobody	report	no	Ginny	locution	act	Stillman	journey	man	name	sail	remark	land	idleness	thing	rest	talk	thursday	priority	house	matter	standard	figure	market	obstacle	government	action	risk	science	
talk	he	India	we	I	people	i	who	she	they	employee	you	many	Stephen	hymn	leader	her	man	Stillman	wife	vernon	Cœlebs	
point	Kalkat	many	detail	supporter	road	research	I	reader	we	Waters	santer	he	rapporteur	they	Saintsbury	
write	Judge	Ramtanu	he	Jeff	I	Aldo	PEREZ	Ruy	people	you	they	one	Darin	who	writer	she	Walt	onion	which	poster	we	Yehoshua	Access	kedourie	executive	hogwart	neither	Virginia	russian	Balzac	Rolf	father	Pritchett	Flaubert	Proust	James	Friedrich	John	Shakespeare	essayist	Ewelina	assistant	Jesse	Meyer	artist	
end	story	we	you	it	Beijing	life	operation	I	he	thing	hall	boom	game	war	day	tax	that	they	commercial	attempt	
follow	who	that	what	it	mailing	I	invitation	we	they	launch	NASA	you	direction	divorce	John	he	acquisition	Trail	step	report	harry	shriek	plant	twins	collection	which	
part	they	
show	government	that	he	Bush	Pakistan	George	form	papers	we	they	name	Craig	it	who	schedule	%	deviation	system	record	letter	phoebe	half	analysis	some	website	beam	i	chick	experience	family	construction	instructor	girl	guy	Phet	you	van	one	Rohan	I	Anita	DD	survey	her	article	map	father	result	finding	many	plant	video	list	illustration	field	Stillman	Arab	research	United	speck	structure	woman	shirt	view	scene	study	nose	dursley	parliament	button	which	intention	report	country	Robin	influence	poem	allusion	scan	leaf	photo	bank	crisis	
state	he	Al	line	Declaration	you	I	we	they	manufacturer	Vladimir	it	page	inspector	website	person	official	report	site	Korea	Administrator	that	paper	chair	rapporteur	Cuthbert	head	Mestre	
start	they	lesion	he	authority	conflict	chief	Thane	SE	I	body	dancer	it	Andrew	name	company	you	school	troops	tradition	many	law	room	she	that	life	rain	day	friend	daughter	all	quality	work	brother	we	who	everything	shirt	Korea	municipality	development	route	team	game	term	fact	invitation	passenger	harry	crowd	peanuts	miracle	majority	Balzac	one	phone	user	storm	hour	
report	Al	Ministry	navy	Newsweek	ex-member	media	Journal	individual	MSNBC	press	official	we	that	UPI	brief	I	Reuters	paper	News	Ash	he	AP	student	Independent	study	%	who	monde	lomas	biographer	John	authority	government	customer	wife	finding	city	
include	this	Peter	which	article	photograph	note	profile	word	Anne	we	I	that	jurisdiction	document	plan	it	colleague	deal	phase	intention	consequence	species	leap	St	they	military	most	wake	festivity	these	cap	sample	correction	goal	agent	those	study	work	ingredient	group	member	exhibit	collection	model	step	schedule	item	data	you	page	function	total	criterium	right	service	certificate	position	measure	set	workforce	he	actor	candidate	instrument	communication	accolade	island	police	project	letter	invention	clause	
ask	Hiller	Bush	I	Osama	you	Paul	we	employee	Mr.	Marly	s&s	Joe	Loretta	investor	people	John	i	they	someone	he	guest	who	she	Winston	municipality	party	it	Quinn	one	Roly	Harry	voice	wife	rapporteur	Bray	that	harry	Auster	dostoevski	madness	member	
keep	India	Bush	we	you	I	who	that	they	effort	money	i	Nixon	one	team	advisor	he	waitress	which	stylist	Buffet	it	progress	Abbas	she	me	folk	Brooks	earth	clink	harry	chief	some	wizard	key	parliament	face	
feel	Tamils	other	nobody	he	member	you	I	we	governor	mind	organ	ray	one	they	she	i	child	car	customer	hair	place	house	setting	it	what	someone	Quinn	body	Bray	none	clothes	who	people	harry	fire	weasley	doctor	businesspeople	individual	bond	
question	Kerry	Bush	I	you	he	Andy	
put	Kalkat	Force	they	I	she	change	we	you	who	people	war	Iran	country	city	kind	that	i	he	Marek	it	company	John	this	group	person	investor	kitchen	father	Rebecca	interest	Korea	Museum	union	Harry	someone	Wentz	Margot	Jo-Ann	dudley	Auster	fellow	hat	which	minister	struggle	
let	they	who	blogger	I	you	Richard	that	she	i	Johnson	it	he	we	most	mother	which	s/he	superstore	Harry	layout	anybody	lot	Margot	
change	vessel	that	he	nothing	rule	address	I	we	you	Duke	scream	Katrina	it	disaster	folk	this	i	temperature	mark	score	they	guy	event	management	source	Abbas	parent	way	magazine	situation	pointer	user	arrow	data	Access	circumstance	measurement	everything	bench	mechanism	cost	cinema	warfare	
leave	that	Americans	who	shipment	decade	he	I	they	you	we	i	lesson	relation	baby	this	which	pair	staff	decor	grinder	guy	structure	Ahmed	someone	piece	it	alteration	Zionists	Israel	cyclone	million	him	Montalvo	seeker	Paris	thing	history	Germans	bus	steamer	parent	sailor	party	harry	head	mason	era	Shakespeare	many	spending	
name	he	you	Bush	who	K	novelist	edition	
number	author	
where	those	they	
last	surgery	scent	relationship	which	game	that	it	pedicure	strap	ride	glow	reaction	stay	feeling	negotiation	beer	
tell	speech	I	he	Muni	Kalkat	president	Posada	Meiring	President	Mr.	guy	Nadereh	many	paper	Zacarias	Johnelle	Khalid	press	brother	you	Doug	mom	birdie	Kori	we	they	Mark	producer	Kioka	Ed	Beschta	Parmesan	Paul	Karl	i	anybody	vet	employee	Dr.	sister	friend	she	doctor	receptionist	Rod	that	AMS	Musharraf	someone	Pat	Kistler	NASA	anyone	Shojai	Chahine	Michael	Abbas	one	somone	historian	instinct	who	joke	it	biologist	coauthor	Heald	archbishop	Rebecca	Harry	story	Stillman	Quinn	detractor	harry	sign	face	ron	Le	witness	company	spokesman	map	investigator	opposition	man	
here	I	
help	that	you	he	US	Pakistan	job	who	it	scientist	stuff	one	experience	this	I	application	organization	they	filing	God	planning	i	suggestion	someone	picture	anyone	link	brase	antibiotic	answer	change	C	Studio	she	knowledge	FusionRetail	we	information	massage	colonization	anybody	Internet	amount	movement	technique	ruler	use	stand	programme	fund	United	forum	effort	successor	Flaubert	transit	date	strain	architecture	
please	they	joke	I	
service	boat	what	
find	I	you	correspondent	he	enforcement	we	colleague	they	investigation	Peggy	committee	i	William	Ripple	scientist	record	report	ACIA	assessment	diversity	2005	avenger	force	who	she	husband	server	one	Israelis	it	man	service	niche	study	Carroll	Earth	challenge	poll	researcher	people	Quinn	Cervantes	puritan	Vivien	Access	all	cummings	harry	muggle	company	G5	consultancy	author	economy	Ewelina	expression	scholar	pharaoh	China	
new	I	she	
back	that	Ayatollah	country	which	he	one	I	harry	%	
need	we	he	they	leader	story	child	authority	I	you	that	agreement	everybody	department	anyone	any	difference	Enron	commissioner	something	team	guideline	increase	a	language	choice	water	attention	Abby	she	who	rider	letter	this	fish	breyer	i	the	one	friend	beard	foot	user	comment	town	it	area	door	bartender	what	Darfur	guaranty	position	pacman	frog	customer	cat	occupation	u	librarian	aspect	setup	punchline	overall	study	world	passport	citizen	project	seed	cutting	ball	shopkeeper	agency	farmer	control	financing	service	someone	no	much	grass	fungi	formula	business	Brazil	Ukraine	reform	European	administration	more	settler	
give	Saddam	state	which	he	interview	I	we	Sun	it	you	doctor	they	Emma	one	someone	all	bear	USA	Senate	anyone	research	sum	Donald	somebody	fries	that	source	Christiane	farrier	Shee	she	who	shop	department	Alto	Mr.	i	FHS	donor	presentation	Wei	simplicity	uncertainty	anybody	this	what	display	population	chicken	cooker	Auster	knight	archbishop	other	Quinn	boy	yoyo	man	boat	projectile	thing	trouble	dursley	weasley	eugene	nobody	girl	dobby	omission	perception	father	Anne	comedy	fall	more	card	
place	this	we	variation	referee	poll	commission	man	Chamberlain	
think	I	he	you	police	some	we	i	nobody	they	report	shopper	many	someone	mind	people	who	Communists	Americans	vet	owner	one	friend	idiot	it	she	person	volunteer	teacher	culture	creator	Dostoevski	Navrozov	Fresleven	Denis	Harry	Max	Quinn	Stillman	Olivia	bar	harry	atmosphere	company	Plato	Snowman	
come	they	day	child	he	envoy	report	Charles	honesty	intelligence	it	information	Bush	I	George	manager	Mr.	aspect	fear	that	brigade	you	bowl	nature	she	flight	parent	Chicks	we	IRS	what	kaoshikii	award	Sabeer	Paul	money	wolf	John	who	response	cycle	mountain	love	success	land	revolution	disintegration	much	order	visa	pole	station	cheap	version	SOLAS	good	person	Renaissance	visitor	asians	question	animal	potty	everything	nothing	worse	most	guy	i	Scot	zone	dessert	James	enchlada	Sushi	staff	everyone	aunte	tile	guest	A&E	quote	people	mechanic	light	food	reversal	which	meat	wing	word	all	B&B	week	best	bodice	few	threat	px	car	quality	Eric	story	hundred	stock	part	message	Chuck	Phailin	Josh	iodine	payoff	Renata	world	family	da	Clinton	someone	accident	visit	inhabitant	market	Vogel	aviatio	lap	whale	Quinn	Pena	shipment	calamity	impression	caravan	one	sun	servant	Dorothy	voice	Dobby	Stillman	time	darkness	commercial	egg	party	john	wave	door	thing	change	Roman	feeling	puff	law	half	position	man	legislation	hit	country	music	plane	inspector	spider	champagne	Vivien	nose	colonialist	Rebecca	Bray	harry	builder	weasley	gilderoy	chap	trickle	evil	Roland	tray	rain	antibiotic	this	mother	comfort	energy	Principality	retreat	news	council	Americans	war	
want	government	George	they	foreigner	who	we	Venezuela	Chavez	you	I	he	Qaeda	desk	manager	Debbie	guy	she	Craig	department	lawyer	that	Bob	China	anyone	conservationist	majority	family	John	i	yo	pwople	all	dad	everyone	business	girl	people	Tmobile	dealer	old	someone	it	lot	Bisconti	dentist	Iran	Russia	US	administration	Israel	wife	dignitary	Microsoft	anybody	person	Quinn	american	everybody	russian	Englishman	Shakespeare	Ottomans	
people	that	
see	world	I	that	Valley	F	everyone	Rajavis	we	mother	they	you	he	she	Bobby	Dan	monkey	girlfriend	CIA	section	i	who	watcher	anyone	2005	Stark	animal	dog	one	staff	surgeon	director	cop	site	strategy	n3td3v	logician	cellist	girl	Harry	Ginny	many	us	exposure	Museum	year	people	mite	voter	final	neighborhood	development	decade	kitty	no	Quinn	Peter	Auster	left	Bray	harry	navrozov	subscriber	ecologist	marx	physiocrats	person	1831	romantic	naturalist	scholar	commentator	which	
use	they	Muslims	some	Ayad	who	government	it	Egypt	I	murderer	jihadist	Sufaat	FBI	Zawahiri	hr	we	you	counterparty	Enron	rep.	Dr.	Kapor	team	Committee	NASA	elk	that	bear	he	Saddam	friend	she	u	program	i	ammunition	m	one	Officer	cafe	cat	none	answer	Sear's	anybody	anyone	pub	manufacturer	Frank	NBC	Eberhard	group	religion	peroxide	site	file	view	query	xml	developer	Mweta	arrangement	party	poverty	aristocrat	writer	He	Proust	author	Shakespeare	ANA	appetite	church	
up	light	contact	
take	that	group	guy	he	revolt	which	we	election	it	my	lawmaker	member	generation	functional	anyone	who	this	they	I	Shona	you	meeting	Jen	prepayment	event	people	Constitution	nomination	press	sense	life	Boi	Murillo	center	pact	Sunburn	citizen	Bush	process	she	bredder	Pioneers	photographer	snake	fancy	vet	troops	one	teeth	i	Seth	atmosphere	man	girlfriend	friend	Dan	billing	job	wife	Mike	everyone	min	negotiation	owner	Iraqis	rally	Greg	university	Marines	option	affliction	person	post	waitress	repair	them	father	government	problem	treatment	One	Games	mill	work	initiation	NATO	worker	review	interview	hashtag	obsession	stampede	program	maid	city	route	positing	adjustment	Expo	demonstration	Discovery	traveler	child	mouse	cat	Teddy	lot	William	Weasley	Stillman	david	no	wilderness	evaluation	vote	standard	presidency	Mweta	plane	party	Dando	husband	Ras	harry	george	weasley	scene	monde	change	Olivia	Edward	face	minute	rapporteur	committee	commission	entrepreneur	parliament	European	ANA	programme	action	currency	trade	winner	policymakers	journey	Flaubert	partnership	exercise	Germany	pair	world	authority	Peniston	Mishima	conservative	dedication	king	Revolution	Emperor	development	
know	you	we	Bush	Edwards	George	who	I	he	fellow	they	ye	law	one	profiler	CIA	most	this	everyone	anyone	tyrant	any	many	people	i	teacher	that	bird	she	mines	guy	chef	person	lot	Doctor	lady	driver	woman	diner	civilian	wife	anybody	Daniel	parent	them	experimenter	fan	some	answer	everybody	voter	Dobby	Quinn	Stillman	body	whoever	jew	it	sailor	brittan	both	god	mind	nobody	Bray	petunia	harry	guest	american	goodness	all	dursley	physicist	'ya	
like	he	which	I	you	we	Archibald	leader	Qaeda	Erin	Ken	she	Danelia	DB	some	Corp.	Susan	who	anyone	representative	group	they	people	parent	bird	nobody	Parisians	i	dog	mouse	sister	wife	one	Scott	father	Warhol	Quinn	audience	dursley	weasley	Fungi	
so	you	
get	we	you	Shiites	daddy	anyone	he	Delhi	candidate	material	county	America	it	I	terrorist	something	she	e-mail	Travis	flight	they	question	daughter	generator	mommy	Jack	Mitch	Senate	target	Don	rejection	chauvinism	female	Orla	many	i	this	male	receiver	americans	passport	ad	rabbit	fume	charcoal	which	that	snake	Liberty	back	area	horse	place	guy	one	staff	husband	student	parent	everyone	customer	technician	share	Hezbollah	Dick	detail	here	ppl	port	army	wolf	Bush	CPA	some	who	wife	us	foetus	infant	woman	people	man	ant	Frank	wikiHow	editor	group	airline	tree	congestion	those	Everyone	step	more	glow	astronaut	Pittsburgh	Stearns	thing	cause	farm	state	concept	Neil	house-elf	father	what	detective	wire	reader	PCB	activist	country	Britain	Tuesday	Johnny	
say	commission	tv	they	President	Bush	Gore	David	literature	he	source	Kalkat	officer	Col.	Campenni	evaluation	veterans	Kerry	police	official	Amrullah	diplomat	Karzai	Musharraf	Barno	Groom	Archibald	Murph	Mike	spokesman	investigator	Dean	Jeffs	Afshari	I	who	Michael	Mohammed	that	it	Zawahiri	attorney	islamist	Van	report	Ken	Brian	draft	license	guy	Ryan	she	we	Mark	mail	woman	Debbie	Reggie	Cindy	ma	Linda	Wolak	dept	Edison	Dunn	Steve	Maviglio	Gregg	Fishman	Robinson	Jan	Smutney	Hoecker	Terry	ye	Jesus	Dr.	expert	mayor	Kathleen	resident	Ray	Corps	Alastair	Haley	Vincent	analyst	Claude	Group	Jason	which	Joan	Johnson	Allard	Beutel	John	Pike	myself	message	you	Bangs	Camille	Robert	politician	Mayor	curate	Don	Sancho	George	marriage	receptionist	Paul	logic	Cheney	visa	i	Microsoft	Sony	calculater	brother	poster	other	parent	vet	french	lady	Scotsman	lot	owner	Shee	sign	dealer	one	reviewer	greeter	office	mechanic	person	Gerry	PA	someone	man	AMS	statement	Nihad	Gordon	Foundation	Winston	boy	Walter	letter	all	G	Muqtada	Masoud	Nina	Chahine	memoirs	theme	al	James	Center	Valero	Brett	Griffin	Israel	Habib	everyone	Tom	researcher	author	professor	Ms	legend	traveler	Renata	doctor	mother	Carroll	her	Veronique	rest	E-mail	Poet	back	Stephen	Colbert	general	Minister	Department	father	Alia	president	director	Khaled	emeritus	post	firm	KCNA	Korea	Mauer	Gustafon	Wilkins	Kathryn	Water	Allton	Agency	this	Derya	Bolden	Governor	Baird	government	Dewar	fed	Quinn	counterman	Alexanian	cousin	Nota	Kahn	Yehoshua	cockney	Kabata	Vivien	Neil	Dorothy	Harry	Vernon	Dobby	elf	Fred	Weasley	philosopher	Auster	wife	monde	sage	shahar	kedourie	compson	people	john	crew	harold	Marlow	Swede	predecessor	Olivia	Mweta	Bray	Roland	Wentz	Hjalmar	husband	Odara	Margot	vernon	ron	dudley	harry	fred	george	weasley	borgin	malfoy	hagrid	andrei	librarian	Roly	Dando	mister	Some	Robb	Hugo	Engels	critic	Lehan	Joe	Saqib	mr	review	scientist	Erik	Tarlo	Pall	association	Guilbeault	Mailis	Dietrich	Services	Leive	Zimmer	spokeswoman	Barratt	American	González	Bogd	Malleus	Dündar	ms.	
will	you	Ukrainian	amendment	
we	picture	
do	he	we	radiation	party	US	Iraq	Bush	Saddam	Colombo	Pakistan	general	that	they	which	you	Delhi	election	who	adult	relative	Spain	Hambali	mission	FBI	coordinator'	some	Rothko	I	Barbara	site	Eric	guy	Chris	what	girl	mom	none	bidder	muni	form	Terry	operator	monkey	parent	she	government	people	Jane	missile	occupation	Wood	i	plaster	it	owner	corn	Hospital	female	cat	dad	the	human	rabbit	place	crew	answer	this	family	one	farrier	vet	farmer	MSU	Cj	Mark	folk	Westfield	superintendant	Mike	manager	hotel	u	runflat	Derrick	restaurant	leader	Cheney	mine	country	google	CPA	couple	industry	Abbas	Frank	twelve	Jason	mechanic	seamstress	child	everyone	Devil	staff	specie	much	Barack	Bob	McDonnell	Thai	man	food	majority	designer	Stillman	siri	power	commissioner	colleague	commission	hitler	malfoy	nothing	music	other	many	state	replacement	Shakespeare	flick	Palmer	tsar	
it	bond	
in	that	
to	we	
be	this	jump	talk	ten	they	nothing	normal	rumour	version	evidence	one	increase	effect	lot	wealth	doubt	these	thing	problem	answer	hint	option	reality	reason	period	glut	statement	opinion	Americans	hope	way	border	object	catch	foreigner	Delhi	agent	sign	cooperation	attempt	pull	that	it	question	place	Republicans	impression	cache	mechanism	concern	who	abuse	marrying	praise	distinction	point	20,000	I	he	fan	conflict	show	root	people	despair	game	example	circle	half	habit	disregard	penalty	news	plan	guidance	what	risk	control	charge	dominance	clump	duster	Aafia	pursuit	consensus	mailing	purpose	reward	claim	explanation	chapter	nature	search	agenda	sheet	Lichtenstein	concept	1	article	consistency	last	work	issue	fact	she	plenty	information	date	address	bunch	dude	volume	share	someone	reaction	goal	joy	pleasure	fun	least	anyone	death	proposal	Mark	objection	we	guaranty	swing	change	number	solution	understanding	intention	difference	benefit	expectation	probability	ECS	thought	availability	hearing	freedom	preference	counterparty	suggestion	procedure	meeting	lead	chance	alternative	minute	parentheses	thinking	any	which	you	condition	aim	take	priority	employee	kid	noone	separation	escape	health	belief	bear	fur	forum	website	requirement	some	couple	panic	waste	site	page	link	warmth	meaning	need	saying	idea	possibility	lyric	all	group	wolf	none	colony	nine	lion	distance	gall	family	punch	Jews	nobody	sound	signal	then	misery	recruiting	States	policy	bet	load	press	something	dirt	cure	function	anything	key	t2i	wheel	office	advice	argument	is	food	worm	aperture	part	pro	baby	detail	i	brunch	law	venue	similarity	market	nightlife	aftershock	cascade	complex	blood	exam	element	corner	custom	cruise	presence	influence	house	opportunity	four	hotel	downside	variety	50	more	trick	much	pose	dating	job	future	interest	snake	book	light	area	guess	rain	Kerry	pub	yours	mineral	level	grist	ship	region	amnesty	fountain	pool	horse	treatment	testament	Verizon	confusion	location	furniture	customer	space	advise	dip	delivery	gift	traffic	mine	cheese	car	chick	stoner	riso	mousse	hospitality	day	Dr.	hole	reviews	coffee	camera	excuse	pet	guy	breakfast	glitch	ounce	side	name	waiting	conclusion	2	fat	steak	rule	building	restaurant	wait	canape'	ad	bigger	appointment	line	design	deposit	friend	peanut	person	mechanic	adult	truth	dessert	table	sort	proof	justification	view	Bill	debate	hundred	target	god	correlation	request	credit	blank	reduction	talent	effort	development	deal	companion	koreans	korean	snow	floor	painting	Donald	NCL	16	statue	gimmick	pancake	rating	client	surprise	wave	history	punchline	demonstration	tension	photo	horseman	speculation	motive	fallacy	premise	power	girl	hour	pledge	theory	subterfuge	result	coefficient	attachment	picture	spasm	Pepsi	unit	blogger	peace	several	thousand	blackberry	egg	bird	Miramar	time	storage	cab	Govt	male	cola	staff	attraction	shop	review	participant	campaign	class	holder	rustling	cricket	click	Jeff	Jason	machine	being	war	Arab	potential	iodine	beach	influx	flight	tunnel	motif	column	artwork	performance	variability	bit	couch	desk	Renata	Sonia	fate	gunfire	inscription	case	money	magician	defense	quid	Union	ecosystem	trip	biologist	gene	misconception	accouterment	supply	wear	test	eHow	team	Cup	strength	joke	odd	topic	sentence	end	beginning	clarification	video	quote	casualty	section	sea	exhibit	Warhol	art	passport	business	tax	company	town	abundance	salon	ton	Plants	nightclub	charm	Terminal	room	destination	campsite	center	bus	transport	Rose	storm	festival	style	code	basil	sunshine	him	Chinese	rise	community	bite	logic	denying	word	mite	Exchange	heap	precedent	paper	draw	shoe	wind	recipe	field	Rusty	no	comfort	bulb	spot	bread	piece	Dostoevski	woman	amount	steamer	other	paragraph	mistake	pennant	arch	sabre	ceiling	face	illness	silence	list	salespeople	event	world	motion	park	Frick	task	operation	boss	step	first	clue	measure	Paul	mention	spell	apartment	twist	beauty	Quinn	phone	rabbi	dollar	ambassador	democracy	egypt	life	relic	matter	streak	right	bond	mist	mind	home	country	darkness	initiation	N	river	shed	touch	camp	station	cliff	joint	rapids	expression	smile	check	seal	rest	rumor	Kurtz	hurry	fragment	air	reference	creator	use	product	ball	circumvention	boat	union	two	8	celebration	uprush	façade	Adamson	else	owl	everything	night	circumference	spring	smell	meal	bottle	department	magistrate	administration	tremor	assistant	moment	attainment	ceremony	party	Bray	father	Margot	ugliness	eye	Pettigrew	roar	response	scar	year	dinner	voldemort	trouble	ron	bar	diversion	display	pile	data	photograph	ocean	chart	material	pimple	Stillman	russian	attitude	olive	boy	romanticism	doctor	movement	murmur	ground	call	offer	chemical	spirit	drug	voice	path	leopard	Shinza	Mweta	president	interview	Bayley	scream	tree	noise	mushroom	mile	manufacturing	drill	instructions	message	text	amendment	disaster	circumstance	support	funding	coherence	communication	publicity	flexibility	prioritization	participation	man	diagram	predator	firm	challenge	shortcoming	enthusiasm	puzzle	determinant	sector	growth	dimension	surrendering	structure	oppression	vaccine	Balzac	crow	lack	parallel	fault	factor	exchange	mla	story	Bob	parade	volunteer	language	here	analysis	recognition	opponent	ETA	cloister	economy	trace	artifact	
