演成	女子	
放到	模型	
訴諸	法庭	
授與	人	
傳給	努兒道刺特	
滴下	土壤	
詢問	路濟亞	
叫作	象	
拖進	井	
運回	機	
租予	租客	
衝出	香港	
讓給	秀次	
割予	沙俄	
投到	基金	
排入	海洋	
打成	平局	
彈入	空中	
分割	同盟	
傳遍	星球	
藏在	假髮	
畫上	等號	
傳到	白紙	
搬往	屯門	納什維爾	
拍成	版	電影	
帶到	家中	
伸出	海面	
供給	學生	
劃入	領土	
判處	恩寵	
對準	她	
送到	高地	
帶給	觀眾	
賦予	隊員	古巴	
併入	新區	
问	我们	
交給	妻子	斯瓦爾恩	宗教	員工	艦	
支付	方	
當作	景點	工具	
教導	莉拉	人	
收	你	
授予	他	柯林頓	守護者們	韋斯	
留	巴黎	
建成	棉花廠	
考慮	在內	
給予	人類	中國	作者	人	明星	個人	
變成	地盤	真人	豬	
改變	信仰	
找	你	
打	她	
教	外国人	
提供	居民	學生	
作	旋律	
成	曲	
有	聯系	
